"lang"
{
"Language"	"finnish"
"Tokens"
{
"DOTA_WearableType_Daggers"	"tikaripari"
"[english]DOTA_WearableType_Daggers"	"Daggers"
"DOTA_WearableType_Glaives"	"teräpari"
"[english]DOTA_WearableType_Glaives"	"Glaives"
"DOTA_WearableType_Weapon"	"ase"
"[english]DOTA_WearableType_Weapon"	"Mace"
"DOTA_WearableType_Armor"	"panssari"
"[english]DOTA_WearableType_Armor"	"armor"
"DOTA_WearableType_Hair"	"kuontalo"
"[english]DOTA_WearableType_Hair"	"Hair"
"DOTA_WearableType_Belt"	"vyö"
"[english]DOTA_WearableType_Belt"	"belt"
"DOTA_WearableType_Mask"	"naamio"
"[english]DOTA_WearableType_Mask"	"Mask"
"DOTA_WearableType_Cape"	"viitta"
"[english]DOTA_WearableType_Cape"	"cape"
"DOTA_WearableType_Bracer"	"rannesuoja"
"[english]DOTA_WearableType_Bracer"	"Bracer"
"DOTA_WearableType_Boots"	"saapaspari"
"[english]DOTA_WearableType_Boots"	"Boots"
"DOTA_WearableType_Hands"	"käsinepari"
"[english]DOTA_WearableType_Hands"	"Hands"
"DOTA_WearableType_Head"	"pää"
"[english]DOTA_WearableType_Head"	"head"
"DOTA_WearableType_Mace"	"sotanuija"
"[english]DOTA_WearableType_Mace"	"Mace"
"DOTA_WearableType_Gauntlet"	"hansikas"
"[english]DOTA_WearableType_Gauntlet"	"Gauntlet"
"DOTA_WearableType_Shoulder"	"olkapanssari"
"[english]DOTA_WearableType_Shoulder"	"shoulder"
"DOTA_WearableType_Bow"	"jousi"
"[english]DOTA_WearableType_Bow"	"Bow"
"DOTA_WearableType_ShoulderPads"	"hartiasuojus"
"[english]DOTA_WearableType_ShoulderPads"	"Shoulderpads"
"DOTA_WearableType_Quiver"	"nuoliviini"
"[english]DOTA_WearableType_Quiver"	"Quiver"
"DOTA_WearableType_Shield"	"kilpi"
"[english]DOTA_WearableType_Shield"	"Shield"
"DOTA_WearableType_Horns"	"sarvipari"
"[english]DOTA_WearableType_Horns"	"Horns"
"DOTA_WearableType_Beard"	"parta"
"[english]DOTA_WearableType_Beard"	"Beard"
"DOTA_WearableType_Necklace"	"kaulakoru"
"[english]DOTA_WearableType_Necklace"	"Necklace"
"DOTA_WearableType_Fish_Treat"	"kalaherkku"
"[english]DOTA_WearableType_Fish_Treat"	"Fish Treat"
"DOTA_WearableType_Meathook"	"lihakoukku"
"[english]DOTA_WearableType_Meathook"	"Meathook"
"DOTA_WearableType_Offhand_weapon"	"toisen käden ase"
"[english]DOTA_WearableType_Offhand_weapon"	"Offhand Weapon"
"DOTA_WearableType_Back"	"selkä"
"[english]DOTA_WearableType_Back"	"back"
"DOTA_WearableType_Gloves"	"hanskapari"
"[english]DOTA_WearableType_Gloves"	"Gloves"
"DOTA_WearableType_Legs"	"jalkapari"
"[english]DOTA_WearableType_Legs"	"Legs"
"DOTA_WearableType_offhand"	"toisen käden"
"[english]DOTA_WearableType_offhand"	"offhand"
"DOTA_WearableType_arms"	"käsivarret"
"[english]DOTA_WearableType_arms"	"Arms"
"DOTA_WearableType_Unnamed_New_Item"	"uusi esine"
"[english]DOTA_WearableType_Unnamed_New_Item"	"New Item"
"DOTA_WearableType_New_Item"	"uusi esine"
"[english]DOTA_WearableType_New_Item"	"New Item"
"DOTA_WearableType_body"	"keho"
"[english]DOTA_WearableType_body"	"Body"
"DOTA_WearableType_Tail"	"häntä"
"[english]DOTA_WearableType_Tail"	"Tail"
"DOTA_WearableType_Pauldrons"	"olkasuoja"
"[english]DOTA_WearableType_Pauldrons"	"Pauldrons"
"DOTA_WearableType_Chain_Weapon"	"ketjuase"
"[english]DOTA_WearableType_Chain_Weapon"	"Chain Weapon"
"DOTA_WearableType_Helm"	"kypärä"
"[english]DOTA_WearableType_Helm"	"Helm"
"DOTA_WearableType_Pegleg"	"tee se itse -proteesi"
"[english]DOTA_WearableType_Pegleg"	"Makeshift Prosthetic"
"DOTA_WearableType_Sword"	"miekka"
"[english]DOTA_WearableType_Sword"	"Sword"
"DOTA_WearableType_Hat"	"päähine"
"[english]DOTA_WearableType_Hat"	"Hat"
"DOTA_WearableType_Ability_Modifier"	"kyvynmuokkaaja"
"[english]DOTA_WearableType_Ability_Modifier"	"Ability Modifier"
"DOTA_WearableType_Toga"	"tooga"
"[english]DOTA_WearableType_Toga"	"Toga"
"DOTA_WearableType_Hand"	"käsi"
"[english]DOTA_WearableType_Hand"	"Hand"
"DOTA_WearableType_Taunt"	"pilkka"
"[english]DOTA_WearableType_Taunt"	"Taunt"
"DOTA_WearableType_Skin"	"nahka"
"[english]DOTA_WearableType_Skin"	"Skin"
"DOTA_WearableType_Alternate_Ultimate"	"vaihtoehtoinen Ultimate"
"[english]DOTA_WearableType_Alternate_Ultimate"	"Alternate Ultimate"
"DOTA_WearableType_Alternate_Attack"	"vaihtoehtoishyökkäys"
"[english]DOTA_WearableType_Alternate_Attack"	"Alternate Attack"
"DOTA_WearableType_Pauldron"	"olkasuoja"
"[english]DOTA_WearableType_Pauldron"	"Pauldron"
"DOTA_WearableType_Spaulder"	"olkasuoja"
"[english]DOTA_WearableType_Spaulder"	"Spaulder"
"DOTA_WearableType_Squishy_Hat"	"liiskattu hattu"
"[english]DOTA_WearableType_Squishy_Hat"	"Squishy Hat"
"DOTA_WearableType_Bracers"	"rannesuojapari"
"[english]DOTA_WearableType_Bracers"	"Bracers"
"DOTA_WearableType_Robe"	"kaapu"
"[english]DOTA_WearableType_Robe"	"Robe"
"DOTA_WearableType_Headdress"	"päähine"
"[english]DOTA_WearableType_Headdress"	"Headdress"
"DOTA_WearableType_Mailed_Skirt"	"panssarihelma"
"[english]DOTA_WearableType_Mailed_Skirt"	"Mailed Skirt"
"DOTA_WearableType_Hat_and_Hair"	"hattu ja hiukset"
"[english]DOTA_WearableType_Hat_and_Hair"	"Hat and Hair"
"DOTA_WearableType_Shoes"	"kenkäpari"
"[english]DOTA_WearableType_Shoes"	"Shoes"
"DOTA_WearableType_Spikes"	"piikkirypäs"
"[english]DOTA_WearableType_Spikes"	"Spikes"
"DOTA_WearableType_Bone_Helm"	"luukypärä"
"[english]DOTA_WearableType_Bone_Helm"	"Bone Helm"
"DOTA_WearableType_Mine"	"miina"
"[english]DOTA_WearableType_Mine"	"Mine"
"DOTA_WearableType_Fins"	"Evät"
"[english]DOTA_WearableType_Fins"	"Fins"
"DOTA_WearableType_Axe"	"kirves"
"[english]DOTA_WearableType_Axe"	"Axe"
"DOTA_WearableType_Shoulder_Guard"	"olkapanssari"
"[english]DOTA_WearableType_Shoulder_Guard"	"Shoulder Guard"
"DOTA_WearableType_Cloak_and_Tunic"	"viitta ja tunika"
"[english]DOTA_WearableType_Cloak_and_Tunic"	"Cloak and Tunic"
"DOTA_WearableType_Hammer"	"vasara"
"[english]DOTA_WearableType_Hammer"	"Hammer"
"DOTA_WearableType_Dead_Shark"	"kuollut hai"
"[english]DOTA_WearableType_Dead_Shark"	"Dead Shark"
"DOTA_WearableType_Finished_Lunch"	"syöty lounas"
"[english]DOTA_WearableType_Finished_Lunch"	"Finished Lunch"
"DOTA_WearableType_Bone_Club"	"luunuija"
"[english]DOTA_WearableType_Bone_Club"	"Bone Club"
"DOTA_WearableType_Makeshift_Weapon"	"kotitekoinen ase"
"[english]DOTA_WearableType_Makeshift_Weapon"	"Makeshift Weapon"
"DOTA_WearableType_Shoulderguard"	"olkapanssari"
"[english]DOTA_WearableType_Shoulderguard"	"Shoulderguard"
"DOTA_WearableType_Fancy_Pantaloons"	"jalot jalanpeittäjät"
"[english]DOTA_WearableType_Fancy_Pantaloons"	"Fancy Pantaloons"
"DOTA_WearableType_Cloth_Bracer"	"Kankaiset rannesuojat"
"[english]DOTA_WearableType_Cloth_Bracer"	"Cloth Bracer"
"DOTA_WearableType_Stuffed_Toy"	"pehmolelu"
"[english]DOTA_WearableType_Stuffed_Toy"	"Stuffed Toy"
"DOTA_WearableType_Staff"	"sauva"
"[english]DOTA_WearableType_Staff"	"Staff"
"DOTA_WearableType_Gruesome_Trophies"	"karmeat voitonsaaliit"
"[english]DOTA_WearableType_Gruesome_Trophies"	"Gruesome Trophies"
"DOTA_WearableType_Hood"	"huppu"
"[english]DOTA_WearableType_Hood"	"Hood"
"DOTA_WearableType_Shuriken"	"heittotähti"
"[english]DOTA_WearableType_Shuriken"	"Shuriken"
"DOTA_WearableType_Mancatcher"	"Miehenpyytäjä"
"[english]DOTA_WearableType_Mancatcher"	"Mancatcher"
"DOTA_WearableType_Apron"	"esiliina"
"[english]DOTA_WearableType_Apron"	"Apron"
"DOTA_WearableType_Armlet"	"käsivarsirengas"
"[english]DOTA_WearableType_Armlet"	"Armlet"
"DOTA_WearableType_Scepter"	"valtikka"
"[english]DOTA_WearableType_Scepter"	"Scepter"
"DOTA_WearableType_Abomination"	"kammotus"
"[english]DOTA_WearableType_Abomination"	"Abomination"
"DOTA_WearableType_Greaves"	"Säärisuojukset"
"[english]DOTA_WearableType_Greaves"	"Greaves"
"DOTA_WearableType_Saw"	"saha"
"[english]DOTA_WearableType_Saw"	"Saw"
"DOTA_WearableType_Hook"	"koukku"
"[english]DOTA_WearableType_Hook"	"Hook"
"DOTA_WearableType_Abdomen"	"vatsa"
"[english]DOTA_WearableType_Abdomen"	"Abdomen"
"DOTA_WearableType_Sect_Pauldron"	"lahkon olkasuoja"
"[english]DOTA_WearableType_Sect_Pauldron"	"Sect Pauldron"
"DOTA_WearableType_Sect_Helm"	"Lahkon kypärä"
"[english]DOTA_WearableType_Sect_Helm"	"Sect Helm"
"DOTA_WearableType_Sect_Sword"	"Lahkon miekka"
"[english]DOTA_WearableType_Sect_Sword"	"Sect Sword"
"DOTA_WearableType_Flag"	"lippu"
"[english]DOTA_WearableType_Flag"	"Flag"
"DOTA_WearableType_Blade_RightHand"	"oikean käden terä"
"[english]DOTA_WearableType_Blade_RightHand"	"Blade, Right-Hand"
"DOTA_WearableType_Blade_LeftHand"	"vasemman käden terä"
"[english]DOTA_WearableType_Blade_LeftHand"	"Blade, Left-Hand"
"DOTA_WearableType_Sect_Cape"	"Lahkon viitta"
"[english]DOTA_WearableType_Sect_Cape"	"Sect Cape"
"DOTA_WearableType_Sect_Skirt"	"lahkon helma"
"[english]DOTA_WearableType_Sect_Skirt"	"Sect Skirt"
"DOTA_WearableType_Sect_Gauntlet"	"Lahkon taisteluhansikas"
"[english]DOTA_WearableType_Sect_Gauntlet"	"Sect Gauntlet"
"DOTA_WearableType_Scarf"	"huivi"
"[english]DOTA_WearableType_Scarf"	"Scarf"
"DOTA_WearableType_Leather_Pants"	"nahkahousut"
"[english]DOTA_WearableType_Leather_Pants"	"Leather Pants"
"DOTA_WearableType_Blade_RightHanded"	"oikean käden terä"
"[english]DOTA_WearableType_Blade_RightHanded"	"Blade, Right-Handed"
"DOTA_WearableType_Talisman"	"talismaani"
"[english]DOTA_WearableType_Talisman"	"Talisman"
"DOTA_WearableType_Garland"	"seppele"
"[english]DOTA_WearableType_Garland"	"Garland"
"DOTA_WearableType_Exort_Cape"	"Exort-viitta"
"[english]DOTA_WearableType_Exort_Cape"	"Exort Cape"
"DOTA_WearableType_Exort_Bracer"	"Exort-rannesuoja"
"[english]DOTA_WearableType_Exort_Bracer"	"Exort Bracer"
"DOTA_Item"	"Puettava esine"
"[english]DOTA_Item"	"Wearable"
"DOTA_Custom_Courier"	"Kuriiri"
"[english]DOTA_Custom_Courier"	"Courier"
"DOTA_Custom_HexModel"	"Muokattu loitsueläin"
"[english]DOTA_Custom_HexModel"	"Custom Hex Animal"
"DOTA_WearableType_Announcer"	"kuuluttaja"
"[english]DOTA_WearableType_Announcer"	"Announcer"
"DOTA_WearableType_Custom_Courier"	"kuriiri"
"[english]DOTA_WearableType_Custom_Courier"	"Courier"
"DOTA_WearableType_MegaKills"	" "
"[english]DOTA_WearableType_MegaKills"	""
"DOTA_WearableType_Treasure_Chest"	"aarrearkku"
"[english]DOTA_WearableType_Treasure_Chest"	"Treasure Chest"
"DOTA_TreasureChest_Type"	"Aarre"
"[english]DOTA_TreasureChest_Type"	"Treasure"
"DOTA_WearableType_Tool"	"työkalu"
"[english]DOTA_WearableType_Tool"	"Tool"
"DOTA_WearableType_Battle_Bonus"	"taistelubonus"
"[english]DOTA_WearableType_Battle_Bonus"	"Battle Bonus"
"DOTA_Item_Gift"	"Lahja"
"[english]DOTA_Item_Gift"	"Gift"
"DOTA_WearableType_Gift"	"lahja"
"[english]DOTA_WearableType_Gift"	"Gift"
"DOTA_WearableType_Strange_Essence"	"Omituinen olemus"
"[english]DOTA_WearableType_Strange_Essence"	"Strange Essence"
"DOTA_WearableType_LeagueViewPass"	" "
"[english]DOTA_WearableType_LeagueViewPass"	""
"DOTA_WearableType_Bundle"	"paketti"
"[english]DOTA_WearableType_Bundle"	"Bundle"
"DOTA_Wearable_Riki_DefaultWeapon"	"Rikin tikarit"
"[english]DOTA_Wearable_Riki_DefaultWeapon"	"Riki's Daggers"
"DOTA_Item_AntiMages_Glaives"	"Anti-Magen terät"
"[english]DOTA_Item_AntiMages_Glaives"	"Anti-Mage's Glaives"
"DOTA_Item_Desc_AntiMages_Glaives"	" "
"[english]DOTA_Item_Desc_AntiMages_Glaives"	""
"DOTA_Item_Axes_Axe"	"Axen kirves"
"[english]DOTA_Item_Axes_Axe"	"Axe's Axe"
"DOTA_Wearable_Axe_DefaultArmor"	"Axen olkapanssari"
"[english]DOTA_Wearable_Axe_DefaultArmor"	"Axe's Shoulderpad"
"DOTA_Wearable_Axe_DefaultHair"	"Axen heviletti"
"[english]DOTA_Wearable_Axe_DefaultHair"	"Axe's Ponytail"
"DOTA_Item_Axes_Belt"	"Axen vyö"
"[english]DOTA_Item_Axes_Belt"	"Axe's Belt"
"DOTA_Wearable_Jugg_DefaultMask"	"Juggernautin naamio"
"[english]DOTA_Wearable_Jugg_DefaultMask"	"Juggernaut's Mask"
"DOTA_Wearable_Jugg_DefaultWeapon"	"Juggernautin ase"
"[english]DOTA_Wearable_Jugg_DefaultWeapon"	"Juggernaut's Weapon"
"DOTA_Wearable_Jugg_DefaultCape"	"Juggernautin kaapu"
"[english]DOTA_Wearable_Jugg_DefaultCape"	"Juggernaut's Cape"
"DOTA_Wearable_Jugg_DefaultBracers"	"Juggernautin rannesuojat"
"[english]DOTA_Wearable_Jugg_DefaultBracers"	"Juggernaut's Bracers"
"DOTA_Item_Kunkkas_Boots"	"Kunkan kengät"
"[english]DOTA_Item_Kunkkas_Boots"	"Kunkka's Boots"
"DOTA_Item_Kunkkas_Hands"	"Kunkan kädet"
"[english]DOTA_Item_Kunkkas_Hands"	"Kunkka's Hands"
"DOTA_Item_Kunkkas_Sword"	"Kunkan miekka"
"[english]DOTA_Item_Kunkkas_Sword"	"Kunkka's Sword"
"DOTA_Item_Omniknights_Bracers"	"Omniknightin rannesuojat"
"[english]DOTA_Item_Omniknights_Bracers"	"Omniknight's Bracers"
"DOTA_Item_Desc_Bracers"	"Omniknightin vanhat rannesuojat"
"[english]DOTA_Item_Desc_Bracers"	"Omniknight's old bracers"
"DOTA_Item_Kunkkas_Head"	"Kunkan pää"
"[english]DOTA_Item_Kunkkas_Head"	"Kunkka's Head"
"DOTA_FacelessVoid_Default_Weapon"	"Faceless Voidin ase"
"[english]DOTA_FacelessVoid_Default_Weapon"	"Faceless Void's Weapon"
"DOTA_Wearable_Sven_DefaultHead"	"Svenin kypärä"
"[english]DOTA_Wearable_Sven_DefaultHead"	"Sven's Mask"
"DOTA_Wearable_Sven_DefaultSword"	"Svenin miekka"
"[english]DOTA_Wearable_Sven_DefaultSword"	"Sven's Sword"
"DOTA_Wearable_Sven_DefaultBelt"	"Svenin vyö"
"[english]DOTA_Wearable_Sven_DefaultBelt"	"Sven's Belt"
"DOTA_Wearable_Sven_DefaultGauntlet"	"Svenin käsine"
"[english]DOTA_Wearable_Sven_DefaultGauntlet"	"Sven's Gauntlet"
"DOTA_Wearable_Sven_DefaultShoulder"	"Svenin olkapanssari"
"[english]DOTA_Wearable_Sven_DefaultShoulder"	"Sven's Shoulder"
"DOTA_Wearable_Windrunner_DefaultHead"	"Windrunnerin pää"
"[english]DOTA_Wearable_Windrunner_DefaultHead"	"Windrunner's Head"
"DOTA_Wearable_Windrunner_DefaultBow"	"Windrangerin jousi"
"[english]DOTA_Wearable_Windrunner_DefaultBow"	"Windrunner's Bow"
"DOTA_Wearable_Windrunner_ShoulderPads"	"Windrunnerin olkasuojukset"
"[english]DOTA_Wearable_Windrunner_ShoulderPads"	"Windrunner's Shoulder Pads"
"DOTA_Wearable_Windrunner_Cape"	"Windrunnerin kaapu"
"[english]DOTA_Wearable_Windrunner_Cape"	"Windrunner's Cape"
"DOTA_Wearable_Windrunner_DefaultQuiver"	"Windrunnerin viini"
"[english]DOTA_Wearable_Windrunner_DefaultQuiver"	"Windrunner's Quiver"
"DOTA_Item_Queen_of_Pains_Weapon"	"Queen of Painin ase"
"[english]DOTA_Item_Queen_of_Pains_Weapon"	"Queen of Pain's Weapon"
"DOTA_Wearable_Silencer_DefaultWeapon"	"Silencerin ase"
"[english]DOTA_Wearable_Silencer_DefaultWeapon"	"Silencer's Weapon"
"DOTA_Wearable_Silencer_DefaultShield"	"Silencerin kilpi"
"[english]DOTA_Wearable_Silencer_DefaultShield"	"Silencer's Shield"
"DOTA_Wearable_Furion_DefaultWeapon"	"Prophetin sauva"
"[english]DOTA_Wearable_Furion_DefaultWeapon"	"Prophet's Staff"
"DOTA_Wearable_Furion_DefaultHorns"	"Prophetin sarvet"
"[english]DOTA_Wearable_Furion_DefaultHorns"	"Prophet's Horns"
"DOTA_Wearable_Furion_DefaultBeard"	"Prophetin parta"
"[english]DOTA_Wearable_Furion_DefaultBeard"	"Prophet's Beard"
"DOTA_Wearable_Furion_DefaultCape"	"Prophetin kaapu"
"[english]DOTA_Wearable_Furion_DefaultCape"	"Prophet's Cape"
"DOTA_Wearable_Furion_DefaultNecklace"	"Prophetin kaulakoru"
"[english]DOTA_Wearable_Furion_DefaultNecklace"	"Prophet's Necklace"
"DOTA_Item_Tidehunters_Bracer"	"Tidehunterin rannesuojat"
"[english]DOTA_Item_Tidehunters_Bracer"	"Tidehunter's Bracer"
"DOTA_Item_Tidehunters_Belt"	"Tidehunterin vyö"
"[english]DOTA_Item_Tidehunters_Belt"	"Tidehunter's Belt"
"DOTA_Item_Tidehunters_Anchor"	"Tidehunterin ankkuri"
"[english]DOTA_Item_Tidehunters_Anchor"	"Tidehunter's Anchor"
"DOTA_Item_Tidehunters_Lunch"	"Tidehunterin lounas"
"[english]DOTA_Item_Tidehunters_Lunch"	"Tidehunter's Lunch"
"DOTA_Wearable_CrystalMaiden_Default_Cape"	"Crystal Maidenin kaapu"
"[english]DOTA_Wearable_CrystalMaiden_Default_Cape"	"Crystal Maiden's Cape"
"DOTA_Wearable_CrystalMaiden_Default_Shoulder_Pads"	"Crystal Maidenin olkasuojaimet"
"[english]DOTA_Wearable_CrystalMaiden_Default_Shoulder_Pads"	"Crystal Maiden's Shoulder Pads"
"DOTA_Wearable_CrystalMaiden_Default_Weapon"	"Crystal Maidenin ase"
"[english]DOTA_Wearable_CrystalMaiden_Default_Weapon"	"Crystal Maiden's Weapon"
"DOTA_Item_Omniknights_Shoulders"	"Omniknightin hartiat"
"[english]DOTA_Item_Omniknights_Shoulders"	"Omniknight's Shoulders"
"DOTA_Item_Desc_Omniknights_Shoulders"	"Omniknightin vanhat hartiat"
"[english]DOTA_Item_Desc_Omniknights_Shoulders"	"Omniknight's old shoulders"
"DOTA_Item_Omniknights_Cape"	"Omniknightin viitta"
"[english]DOTA_Item_Omniknights_Cape"	"Omniknight's Cape"
"DOTA_Item_Desc_Omniknights_Cape"	"Omniknightin vanha viitta"
"[english]DOTA_Item_Desc_Omniknights_Cape"	"Omniknight's old cape"
"DOTA_Item_Omniknights_Weapon"	"Omniknightin ase"
"[english]DOTA_Item_Omniknights_Weapon"	"Omniknight's Weapon"
"DOTA_Item_Desc_Omniknights_Hammer"	"Omniknightin vanha vasara"
"[english]DOTA_Item_Desc_Omniknights_Hammer"	"Omniknight's old hammer"
"DOTA_Item_Omniknights_Head"	"Omniknightin pää"
"[english]DOTA_Item_Omniknights_Head"	"Omniknight's Head"
"DOTA_Item_Desc_Omniknights_Head"	"Omniknightin vanha naama"
"[english]DOTA_Item_Desc_Omniknights_Head"	"Omniknight's old face"
"DOTA_Item_Omniknights_Hair"	"Omniknightin hiukset"
"[english]DOTA_Item_Omniknights_Hair"	"Omniknight's Hair"
"DOTA_Item_Desc_Omniknights_Hair"	"Omniknightin vanhat hiukset"
"[english]DOTA_Item_Desc_Omniknights_Hair"	"Omniknight's old hair"
"DOTA_Item_Pudges_Rusty_Meathook"	"Pudgen ruosteinen lihakoukku"
"[english]DOTA_Item_Pudges_Rusty_Meathook"	"Pudge's Rusty Meathook"
"DOTA_Item_Desc_Rusty_Meathook"	"Ruosteinen ja julmannäköinen lihakoukku."
"[english]DOTA_Item_Desc_Rusty_Meathook"	"A rusted and cruel looking meat hook."
"DOTA_Item_Invokers_Cape"	"Invokerin viitta"
"[english]DOTA_Item_Invokers_Cape"	"Invoker's Cape"
"DOTA_Item_Desc_Invokers_Cape"	" "
"[english]DOTA_Item_Desc_Invokers_Cape"	""
"DOTA_Item_Prophets_Bracers"	"Prophetin rannesuojat"
"[english]DOTA_Item_Prophets_Bracers"	"Prophet's Bracers"
"DOTA_Item_Desc_Copy_of_Prophets_Horns"	" "
"[english]DOTA_Item_Desc_Copy_of_Prophets_Horns"	""
"DOTA_Item_Bounty_Hunters_Weapon"	"Bounty Hunterin ase"
"[english]DOTA_Item_Bounty_Hunters_Weapon"	"Bounty Hunter's Weapon"
"DOTA_Item_Desc_Unnamed_New_Item"	"Tällä uudella esineellä ei ole kuvausta."
"[english]DOTA_Item_Desc_Unnamed_New_Item"	"This new item has no description."
"DOTA_Item_Bounty_Hunters_Offhand_Weapon"	"Bounty Hunterin toisen käden ase"
"[english]DOTA_Item_Bounty_Hunters_Offhand_Weapon"	"Bounty Hunter's Offhand Weapon"
"DOTA_Item_Desc_Copy_of_RWeapon"	"Tällä uudella esineellä ei ole kuvausta."
"[english]DOTA_Item_Desc_Copy_of_RWeapon"	"This new item has no description."
"DOTA_Item_Bounty_Hunters_Back"	"Bounty Hunterin selkä"
"[english]DOTA_Item_Bounty_Hunters_Back"	"Bounty Hunter's Back"
"DOTA_Item_Desc_Copy_of_LWeapon"	"Tällä uudella esineellä ei ole kuvausta."
"[english]DOTA_Item_Desc_Copy_of_LWeapon"	"This new item has no description."
"DOTA_Item_Armor"	"Bounty Hunterin haarniska"
"[english]DOTA_Item_Armor"	"Bounty Hunter's Armor"
"DOTA_Item_Desc_Copy_of_Backpack"	"Tällä uudella esineellä ei ole kuvausta."
"[english]DOTA_Item_Desc_Copy_of_Backpack"	"This new item has no description."
"DOTA_Item_Bounty_Hunters_Shoulder"	"Bounty Hunterin olkapää"
"[english]DOTA_Item_Bounty_Hunters_Shoulder"	"Bounty Hunter's Shoulder"
"DOTA_Item_Desc_Copy_of_Armor"	"Tällä uudella esineellä ei ole kuvausta."
"[english]DOTA_Item_Desc_Copy_of_Armor"	"This new item has no description."
"DOTA_Item_Bounty_Hunters_Bandana"	"Bounty Hunterin päähuivi"
"[english]DOTA_Item_Bounty_Hunters_Bandana"	"Bounty Hunter's Bandana"
"DOTA_Item_Desc_Copy_of_BWeapon"	"Tällä uudella esineellä ei ole kuvausta."
"[english]DOTA_Item_Desc_Copy_of_BWeapon"	"This new item has no description."
"DOTA_Item_Clinkz_Skull"	"Clinkzin kallo"
"[english]DOTA_Item_Clinkz_Skull"	"Clinkz Skull"
"DOTA_Item_Desc_Clinkz_Skull"	"Clinkzin oletuskallo"
"[english]DOTA_Item_Desc_Clinkz_Skull"	"Clinkz default skull"
"DOTA_Item_Clinkz_Bow"	"Clinkzin jousi"
"[english]DOTA_Item_Clinkz_Bow"	"Clinkz Bow"
"DOTA_Item_Desc_Clinkz_Bow"	"Clinkzin oletusjousi"
"[english]DOTA_Item_Desc_Clinkz_Bow"	"Clinkz default Bow"
"DOTA_Item_Clinkz_Shoulder_Pads"	"Clinkzin olkatoppaukset"
"[english]DOTA_Item_Clinkz_Shoulder_Pads"	"Clinkz Shoulder Pads"
"DOTA_Item_Desc_Clinkz_Shoulder_Pads"	"Clinkzin oletusolkatoppaukset"
"[english]DOTA_Item_Desc_Clinkz_Shoulder_Pads"	"Clinkz default Shoulder Pads"
"DOTA_Item_Clinkz_Quiver"	"Clinkzin nuoliviini"
"[english]DOTA_Item_Clinkz_Quiver"	"Clinkz Quiver"
"DOTA_Item_Desc_Clinkz_Quiver"	"Clinkzin oletusnuoliviini"
"[english]DOTA_Item_Desc_Clinkz_Quiver"	"Clinkz default Quiver"
"DOTA_Item_Clinkz_Horns"	"Clinkzin sarvet"
"[english]DOTA_Item_Clinkz_Horns"	"Clinkz Horns"
"DOTA_Item_Desc_Clinkz_Horns"	"Clinkzin oletussarvet"
"[english]DOTA_Item_Desc_Clinkz_Horns"	"Clinkz default horns"
"DOTA_Item_Clinkz_Gloves"	"Clinkzin hanskat"
"[english]DOTA_Item_Clinkz_Gloves"	"Clinkz Gloves"
"DOTA_Item_Desc_Copy_of_Clinkz_Skull"	"Clinkzin oletuskallo"
"[english]DOTA_Item_Desc_Copy_of_Clinkz_Skull"	"Clinkz default skull"
"DOTA_Wearable_Jugg_DefaultLegs"	"Juggernautin jalat"
"[english]DOTA_Wearable_Jugg_DefaultLegs"	"Juggernaut's Legs"
"DOTA_Item_Dragon_Knights_Helmet"	"Dragon Knightin kypärä"
"[english]DOTA_Item_Dragon_Knights_Helmet"	"Dragon Knight's Helmet"
"DOTA_Item_Desc_Copy_of_Juggernauts_Legs"	" "
"[english]DOTA_Item_Desc_Copy_of_Juggernauts_Legs"	""
"DOTA_Item_Dragon_Knights_Shoulder_Armor"	"Dragon Knightin olkapanssari"
"[english]DOTA_Item_Dragon_Knights_Shoulder_Armor"	"Dragon Knight's Shoulder Armor"
"DOTA_Item_Desc_Dragon_Knights_Shoulder_Armor"	" "
"[english]DOTA_Item_Desc_Dragon_Knights_Shoulder_Armor"	""
"DOTA_Item_Dragon_Knights_Bracers"	"Dragon Knightin rannesuojat"
"[english]DOTA_Item_Dragon_Knights_Bracers"	"Dragon Knight's Bracers"
"DOTA_Item_Desc_Copy_of_Dragon_Knights_Shoulder_Armor"	" "
"[english]DOTA_Item_Desc_Copy_of_Dragon_Knights_Shoulder_Armor"	""
"DOTA_Item_Dragon_Knights_Weapon"	"Dragon Knightin ase"
"[english]DOTA_Item_Dragon_Knights_Weapon"	"Dragon Knight's Weapon"
"DOTA_Item_Desc_Dragon_Knights_Weapon"	" "
"[english]DOTA_Item_Desc_Dragon_Knights_Weapon"	""
"DOTA_Item_Desc_Dragon_Knights_Offhand"	" "
"[english]DOTA_Item_Desc_Dragon_Knights_Offhand"	""
"DOTA_Item_Dragon_Knights_Skirt"	"Dragon Knightin helma"
"[english]DOTA_Item_Dragon_Knights_Skirt"	"Dragon Knight's Skirt"
"DOTA_Item_Desc_Copy_of_Dragon_Knights_Offhand"	" "
"[english]DOTA_Item_Desc_Copy_of_Dragon_Knights_Offhand"	""
"DOTA_Item_Blood_Seekers_Weapon"	"Bloodseekerin ase"
"[english]DOTA_Item_Blood_Seekers_Weapon"	"Blood Seeker's Weapon"
"DOTA_Item_Desc_Copy_of_Dragon_Knights_Skirt"	" "
"[english]DOTA_Item_Desc_Copy_of_Dragon_Knights_Skirt"	""
"DOTA_Item_Blood_Seekers_Headdress"	"Bloodseekerin päähine"
"[english]DOTA_Item_Blood_Seekers_Headdress"	"Blood Seeker's Headdress"
"DOTA_Item_Desc_Blood_Seekers_Headdress"	" "
"[english]DOTA_Item_Desc_Blood_Seekers_Headdress"	""
"DOTA_Item_Blood_Seekers_Offhand_Weapon"	"Bloodseekerin tukikäden ase"
"[english]DOTA_Item_Blood_Seekers_Offhand_Weapon"	"Blood Seeker's Offhand Weapon"
"DOTA_Item_Desc_Copy_of_Blood_Seekers_Headdress"	" "
"[english]DOTA_Item_Desc_Copy_of_Blood_Seekers_Headdress"	""
"DOTA_Item_Blood_Seekers_Necklace"	"Bloodseekerin kaulakoru"
"[english]DOTA_Item_Blood_Seekers_Necklace"	"Blood Seeker's Necklace"
"DOTA_Item_Desc_Copy_of_Blood_Seekers_Offhand_Weapon"	" "
"[english]DOTA_Item_Desc_Copy_of_Blood_Seekers_Offhand_Weapon"	""
"DOTA_Item_Blood_Seekers_Cape"	"Bloodseekerin viitta"
"[english]DOTA_Item_Blood_Seekers_Cape"	"Blood Seeker's Cape"
"DOTA_Item_Desc_Copy_of_Blood_Seekers_Necklace"	" "
"[english]DOTA_Item_Desc_Copy_of_Blood_Seekers_Necklace"	""
"DOTA_Item_Blood_Seekers_Bracers"	"Bloodseekerin rannesuojat"
"[english]DOTA_Item_Blood_Seekers_Bracers"	"Blood Seeker's Bracers"
"DOTA_Item_Desc_Copy_of_Blood_Seekers_Cape"	" "
"[english]DOTA_Item_Desc_Copy_of_Blood_Seekers_Cape"	""
"DOTA_Item_Drows_Bracers"	"Drowin rannesuojat"
"[english]DOTA_Item_Drows_Bracers"	"Drow's Bracers"
"DOTA_Item_Desc_Copy_of_Blood_Seekers_Bracers"	" "
"[english]DOTA_Item_Desc_Copy_of_Blood_Seekers_Bracers"	""
"DOTA_Item_Drows_Cape"	"Drowin viitta"
"[english]DOTA_Item_Drows_Cape"	"Drow's Cape"
"DOTA_Item_Desc_Copy_of_Drows_Bracers"	" "
"[english]DOTA_Item_Desc_Copy_of_Drows_Bracers"	""
"DOTA_Item_Drows_Bow"	"Drowin jousi"
"[english]DOTA_Item_Drows_Bow"	"Drow's Bow"
"DOTA_Item_Desc_Copy_of_Drows_Cape"	" "
"[english]DOTA_Item_Desc_Copy_of_Drows_Cape"	""
"DOTA_Item_Desc_Drows_Leg_Armor"	" "
"[english]DOTA_Item_Desc_Drows_Leg_Armor"	""
"DOTA_Item_Drows_Quiver"	"Drowin nuoliviini"
"[english]DOTA_Item_Drows_Quiver"	"Drow's Quiver"
"DOTA_Item_Desc_Copy_of_Drows_Leg_Armor"	" "
"[english]DOTA_Item_Desc_Copy_of_Drows_Leg_Armor"	""
"DOTA_Item_Drows_Shoulder_Armor"	"Drowin olkapanssari"
"[english]DOTA_Item_Drows_Shoulder_Armor"	"Drow's Shoulder Armor"
"DOTA_Item_Desc_Copy_of_Drows_Quiver"	" "
"[english]DOTA_Item_Desc_Copy_of_Drows_Quiver"	""
"DOTA_Item_Kunkkas_Spyglass"	"Kunkan kaukoputki"
"[english]DOTA_Item_Kunkkas_Spyglass"	"Kunkka's Spyglass"
"DOTA_Item_Desc_Copy_of_Kunkkas_Head"	" "
"[english]DOTA_Item_Desc_Copy_of_Kunkkas_Head"	""
"DOTA_Item_Queen_of_Pains_Wings"	"Queen of Painin siivet"
"[english]DOTA_Item_Queen_of_Pains_Wings"	"Queen of Pain's Wings"
"DOTA_Item_Desc_Copy_of_Queen_of_Pains_Weapon"	" "
"[english]DOTA_Item_Desc_Copy_of_Queen_of_Pains_Weapon"	""
"DOTA_Item_Queen_of_Pains_Armor"	"Queen of Painin panssari"
"[english]DOTA_Item_Queen_of_Pains_Armor"	"Queen of Pain's Armor"
"DOTA_Item_Desc_Copy_of_Queen_of_Pains_Wings"	" "
"[english]DOTA_Item_Desc_Copy_of_Queen_of_Pains_Wings"	""
"DOTA_Item_Queen_of_Pains_Hair"	"Queen of Painin hiukset"
"[english]DOTA_Item_Queen_of_Pains_Hair"	"Queen of Pain's Hair"
"DOTA_Item_Desc_Copy_of_Queen_of_Pains_Armor"	" "
"[english]DOTA_Item_Desc_Copy_of_Queen_of_Pains_Armor"	""
"DOTA_Item_Ursas_Helmet"	"Ursan kypärä"
"[english]DOTA_Item_Ursas_Helmet"	"Ursa's Helmet"
"DOTA_Item_Desc_Copy_of_Queen_of_Pains_Hair"	" "
"[english]DOTA_Item_Desc_Copy_of_Queen_of_Pains_Hair"	""
"DOTA_Item_Ursas_Fur"	"Ursan turkki"
"[english]DOTA_Item_Ursas_Fur"	"Ursa's Fur"
"DOTA_Item_Desc_Copy_of_Ursas_Helmet"	" "
"[english]DOTA_Item_Desc_Copy_of_Ursas_Helmet"	""
"DOTA_Item_Ursas_Bracers"	"Ursan rannesuojat"
"[english]DOTA_Item_Ursas_Bracers"	"Ursa's Bracers"
"DOTA_Item_Desc_Copy_of_Ursas_Fur"	" "
"[english]DOTA_Item_Desc_Copy_of_Ursas_Fur"	""
"DOTA_Item_Desc_Copy_of_Ursas_Bracers"	" "
"[english]DOTA_Item_Desc_Copy_of_Ursas_Bracers"	""
"DOTA_Item_Invokers_Shoulder"	"Invokerin olkapää"
"[english]DOTA_Item_Invokers_Shoulder"	"Invoker's Shoulder"
"DOTA_Item_Facelesss_Head"	"Faceless Voidin pää"
"[english]DOTA_Item_Facelesss_Head"	"Faceless's Head"
"DOTA_Item_Facelesss_Bracer"	"Faceless's Bracer"
"[english]DOTA_Item_Facelesss_Bracer"	"Faceless's Bracer"
"DOTA_Item_Facelesss_Belt"	"Faceless's Belt"
"[english]DOTA_Item_Facelesss_Belt"	"Faceless's Belt"
"DOTA_Item_Witch_Doctors_Head"	"Witch Doctorin pää"
"[english]DOTA_Item_Witch_Doctors_Head"	"Witch Doctor's Head"
"DOTA_Item_Witch_Doctors_Belt"	"Witch Doctorin vyö"
"[english]DOTA_Item_Witch_Doctors_Belt"	"Witch Doctor's Belt"
"DOTA_Item_Witch_Doctors_Staff"	"Witch Doctorin sauva"
"[english]DOTA_Item_Witch_Doctors_Staff"	"Witch Doctor's Staff"
"DOTA_Item_Invokers_Head"	"Invoker's Head"
"[english]DOTA_Item_Invokers_Head"	"Invoker's Head"
"DOTA_Item_Invokers_Hair"	"Invokerin hiukset"
"[english]DOTA_Item_Invokers_Hair"	"Invoker's Hair"
"DOTA_Item_Invokers_Bracer"	"Invokerin rannesuoja"
"[english]DOTA_Item_Invokers_Bracer"	"Invoker's Bracer"
"DOTA_Item_Broodmothers_Hair"	"Broodmotherin karvat"
"[english]DOTA_Item_Broodmothers_Hair"	"Broodmother's Hair"
"DOTA_Item_Broodmothers_Legs"	"Broodmotherin jalat"
"[english]DOTA_Item_Broodmothers_Legs"	"Broodmother's Legs"
"DOTA_Item_Broodmothers_Abdomen"	"Broodmotherin takaruumis"
"[english]DOTA_Item_Broodmothers_Abdomen"	"Broodmother's Abdomen"
"DOTA_Item_Meepos_Weapon"	"Meepon ase"
"[english]DOTA_Item_Meepos_Weapon"	"Meepo's Weapon"
"DOTA_Item_Ogremagis_Weapon"	"Ogremagin ase"
"[english]DOTA_Item_Ogremagis_Weapon"	"Ogremagi's Weapon"
"DOTA_Item_Desc_Copy_of_weapon"	"Tällä uudella esineellä ei ole kuvausta."
"[english]DOTA_Item_Desc_Copy_of_weapon"	"This new item has no description."
"DOTA_Item_Spirit_Breakers_Head"	"Spirit Breakerin pää"
"[english]DOTA_Item_Spirit_Breakers_Head"	"Spirit Breaker's Head"
"DOTA_Item_Desc_Spirit_Breakers_Head"	"Tällä uudella esineellä ei ole kuvausta."
"[english]DOTA_Item_Desc_Spirit_Breakers_Head"	"This new item has no description."
"DOTA_Item_Lone_Druids_Hair"	"Lone Druidin hiukset"
"[english]DOTA_Item_Lone_Druids_Hair"	"Lone Druid's Hair"
"DOTA_Item_Desc_head"	"oletushiukset"
"[english]DOTA_Item_Desc_head"	"default hair"
"DOTA_Item_Lone_Druids_Shoulder_Armor"	"Lone Druidin olkapanssari"
"[english]DOTA_Item_Lone_Druids_Shoulder_Armor"	"Lone Druid's Shoulder Armor"
"DOTA_Item_Desc_Lone_Druids_Shoulder_Armor"	"oletusolkapanssari"
"[english]DOTA_Item_Desc_Lone_Druids_Shoulder_Armor"	"default shoulder armor"
"DOTA_Item_Lone_Druids_Bracers"	"Lone Druidin rannesuojat"
"[english]DOTA_Item_Lone_Druids_Bracers"	"Lone Druid's Bracers"
"DOTA_Item_Desc_Lone_Druids_Bracers"	"oletusrannesuojat"
"[english]DOTA_Item_Desc_Lone_Druids_Bracers"	"default arm item"
"DOTA_Item_Desc_Lone_Druids_Poncho"	"oletusponcho"
"[english]DOTA_Item_Desc_Lone_Druids_Poncho"	"default body item"
"DOTA_Item_Spirit_Breakers_Horns"	"Spirit Breakerin sarvet"
"[english]DOTA_Item_Spirit_Breakers_Horns"	"Spirit Breaker's Horns"
"DOTA_Item_Desc_Copy_of_Spirit_Breakers_Head"	"Tällä uudella esineellä ei ole kuvausta."
"[english]DOTA_Item_Desc_Copy_of_Spirit_Breakers_Head"	"This new item has no description."
"DOTA_Item_Desc_Copy_of_Spirit_Breakers_Horns"	"Tällä uudella esineellä ei ole kuvausta."
"[english]DOTA_Item_Desc_Copy_of_Spirit_Breakers_Horns"	"This new item has no description."
"DOTA_Item_Spirit_Breakers_Mace"	"Spirit Breakerin sotanuija"
"[english]DOTA_Item_Spirit_Breakers_Mace"	"Spirit Breaker's Mace"
"DOTA_Item_Desc_Copy_of_Spirit_Breakers_Shoulder_Armor"	"Tällä uudella esineellä ei ole kuvausta."
"[english]DOTA_Item_Desc_Copy_of_Spirit_Breakers_Shoulder_Armor"	"This new item has no description."
"DOTA_Item_Spirit_Breakers_Tail"	"Spirit Breakerin häntä"
"[english]DOTA_Item_Spirit_Breakers_Tail"	"Spirit Breaker's Tail"
"DOTA_Item_Desc_Copy_of_Spirit_Breakers_Mace"	"Tällä uudella esineellä ei ole kuvausta."
"[english]DOTA_Item_Desc_Copy_of_Spirit_Breakers_Mace"	"This new item has no description."
"DOTA_Item_Spirit_Breakers_Bracers"	"Spirit Breakerin rannesuojat"
"[english]DOTA_Item_Spirit_Breakers_Bracers"	"Spirit Breaker's Bracers"
"DOTA_Item_Desc_Copy_of_Spirit_Breakers_Tail"	"Tällä uudella esineellä ei ole kuvausta."
"[english]DOTA_Item_Desc_Copy_of_Spirit_Breakers_Tail"	"This new item has no description."
"DOTA_Item_Desc_Copy_of_Spirit_Breakers_Bracers"	"Tällä uudella esineellä ei ole kuvausta."
"[english]DOTA_Item_Desc_Copy_of_Spirit_Breakers_Bracers"	"This new item has no description."
"DOTA_Item_Alchemists_Goblin_Body"	"Alchemistin maahisen vartalo"
"[english]DOTA_Item_Alchemists_Goblin_Body"	"Alchemist's Goblin Body"
"DOTA_Item_Alchemists_Weapon"	"Alchemistin ase"
"[english]DOTA_Item_Alchemists_Weapon"	"Alchemist's Weapon"
"DOTA_Item_Alchemists_Saddle"	"Alchemistin satula"
"[english]DOTA_Item_Alchemists_Saddle"	"Alchemist's Saddle"
"DOTA_Item_Alchemists_Gauntlet"	"Alchemistin rautahansikas"
"[english]DOTA_Item_Alchemists_Gauntlet"	"Alchemist's Gauntlet"
"DOTA_Item_Alchemists_Goblin_Hat"	"Alchemistin maahisen hattu"
"[english]DOTA_Item_Alchemists_Goblin_Hat"	"Alchemist's Goblin Hat"
"DOTA_Item_Alchemists_Left_Bottle"	"Alchemistin vasen pullo"
"[english]DOTA_Item_Alchemists_Left_Bottle"	"Alchemist's Left Bottle"
"DOTA_Item_Alchemists_Goblin_Head"	"Alchemistin maahisen pää"
"[english]DOTA_Item_Alchemists_Goblin_Head"	"Alchemist's Goblin Head"
"DOTA_Item_Alchemists_Ogre_Head"	"Alchemistin jätin pää"
"[english]DOTA_Item_Alchemists_Ogre_Head"	"Alchemist's Ogre Head"
"DOTA_Item_Alchemists_Shoulder_Bottle"	"Alchemistin olkapullo"
"[english]DOTA_Item_Alchemists_Shoulder_Bottle"	"Alchemist's Shoulder Bottle"
"DOTA_Item_Phantom_Lancers_Legs"	"Phantom Lancerin jalat"
"[english]DOTA_Item_Phantom_Lancers_Legs"	"Phantom Lancer's Legs"
"DOTA_Item_Desc_Phantom_Lancers_Legs"	"Nää buutsit on mun omat."
"[english]DOTA_Item_Desc_Phantom_Lancers_Legs"	"These boots were made for walkin'."
"DOTA_Item_Phantom_Lancers_Head"	"Phantom Lancerin pää"
"[english]DOTA_Item_Phantom_Lancers_Head"	"Phantom Lancer's Head"
"DOTA_Item_Desc_Phantom_Lancers_Head"	"Tarkoitettu näkemiseen ja puhumiseen. Partakin löytyy."
"[english]DOTA_Item_Desc_Phantom_Lancers_Head"	"For seeing and talking.  There's a beard on it too."
"DOTA_Item_Phantom_Lancers_Belt"	"Phantom Lancerin vyö"
"[english]DOTA_Item_Phantom_Lancers_Belt"	"Phantom Lancer's Belt"
"DOTA_Item_Desc_Phantom_Lancers_Belt"	"Hän on hallitseva raskaansarjan mestari."
"[english]DOTA_Item_Desc_Phantom_Lancers_Belt"	"He's the reigning heavy weight champ."
"DOTA_Item_Desc_Phantom_Lancers_Gauntlet"	"Vain urheimmat soturit taistelevat yhdellä rautahansikkaalla."
"[english]DOTA_Item_Desc_Phantom_Lancers_Gauntlet"	"Only the bravest warriors wear one gauntlet to battle."
"DOTA_Item_Desc_Phantom_Lancers_Shoulderpad"	"Tämä käsisuojus suojaa ikäviltä kissatappeluvammoilta."
"[english]DOTA_Item_Desc_Phantom_Lancers_Shoulderpad"	"This armguard protects from grievous cat-fight injuries."
"DOTA_Item_Phantom_Lancers_Necklace"	"Phantom Lancerin kaulakoru"
"[english]DOTA_Item_Phantom_Lancers_Necklace"	"Phantom Lancer's Necklace"
"DOTA_Item_Desc_Phantom_Lancers_Necklace"	"Jopa soturit haluavat näyttää muodikkailta."
"[english]DOTA_Item_Desc_Phantom_Lancers_Necklace"	"Even warriors like to feel fancy."
"DOTA_Item_Phantom_Lancers_Weapon"	"Phantom Lancerin ase"
"[english]DOTA_Item_Phantom_Lancers_Weapon"	"Phantom Lancer's Weapon"
"DOTA_Item_Desc_Phantom_Lancers_Weapon"	"Piikittelyyn."
"[english]DOTA_Item_Desc_Phantom_Lancers_Weapon"	"For stabbin'."
"DOTA_Item_Ogremagis_Cape"	"Ogremagin viitta"
"[english]DOTA_Item_Ogremagis_Cape"	"Ogremagi's Cape"
"DOTA_Item_Desc_Copy_of_Ogremagis_Weapon"	"Tällä uudella esineellä ei ole kuvausta."
"[english]DOTA_Item_Desc_Copy_of_Ogremagis_Weapon"	"This new item has no description."
"DOTA_Item_Ogremagis_Bracers"	"Ogre Magin rannesuojat"
"[english]DOTA_Item_Ogremagis_Bracers"	"Ogremagi's Bracers"
"DOTA_Item_Desc_Copy_of_Ogremagis_Cape"	"Tällä uudella esineellä ei ole kuvausta."
"[english]DOTA_Item_Desc_Copy_of_Ogremagis_Cape"	"This new item has no description."
"DOTA_Item_Ogremagis_Hats"	"Ogremagin hatut"
"[english]DOTA_Item_Ogremagis_Hats"	"Ogremagi's Hats"
"DOTA_Item_Desc_Copy_of_Ogremagis_Bracers"	"Tällä uudella esineellä ei ole kuvausta."
"[english]DOTA_Item_Desc_Copy_of_Ogremagis_Bracers"	"This new item has no description."
"DOTA_Item_Ogremagis_Belt"	"Ogre Magin vyö"
"[english]DOTA_Item_Ogremagis_Belt"	"Ogremagi's Belt"
"DOTA_Item_Desc_Copy_of_Ogremagis_Hats"	"Tällä uudella esineellä ei ole kuvausta."
"[english]DOTA_Item_Desc_Copy_of_Ogremagis_Hats"	"This new item has no description."
"DOTA_Item_Desc_Pangolin_Shoulder_Armor"	"Pangolin-killan olkasuojainten taidonnäyte. Tarjoaa rautapanssarin verran suojaa, mutta vain murto-osan sen painosta."
"[english]DOTA_Item_Desc_Pangolin_Shoulder_Armor"	"Mastercrafted pauldrons of the Pangolin guild. They offer the strength of platemail at a fraction of the weight."
"DOTA_Item_Desc_The_Blood_Chaser"	"Kolmiosainen ketjujen yhdistämä varsi. Kärjessä kaksiteräinen kirves. Miltei yhtä vaarallinen käyttäjälleen kuin vihollisillekin."
"[english]DOTA_Item_Desc_The_Blood_Chaser"	"A three section chained haft with double bladed axe head at the top. Nearly as dangerous to it's wielder as it is to the enemy."
"DOTA_Item_Timestopper"	"Timestopper"
"[english]DOTA_Item_Timestopper"	"Timestopper"
"DOTA_Wearable_FacelessVoid_Timestopper_Desc"	"Jos sanoin kuvaamaton ulottuvuuksienvälinen valtasi aikaa kohden ei saa pysäytettyä vihollistasi, nuiji hänen päänsä murskaksi."
"[english]DOTA_Wearable_FacelessVoid_Timestopper_Desc"	"If your ineffable transdimensional power over chronology fails to stop your enemy, try hitting them in the head with this sturdy mace."
"DOTA_Wearable_Dazzle_TrolltoothNecklace"	"Peikonhammaskoru"
"[english]DOTA_Wearable_Dazzle_TrolltoothNecklace"	"Trolltooth Necklace"
"DOTA_Wearable_Dazzle_TrolltoothNecklace_Desc"	"Huolellisesti koottu kokoelma peikon hampaita. Jokaiseen hampaaseen on vangittu niiden alkuperäinen omistaja."
"[english]DOTA_Wearable_Dazzle_TrolltoothNecklace_Desc"	"A carefully assembled collection of troll's teeth. Each tooth contains the trapped soul of its former owner."
"DOTA_Item_Dragonclaw_Hook"	"Lohikäärmeenkynsikoukku"
"[english]DOTA_Item_Dragonclaw_Hook"	"Dragonclaw Hook"
"DOTA_Item_Desc_Dragonclaw_Hook"	"Mustan lohikäärmeen vasemman varpaan kynsi. Ainoa Pudgen kyltymättömältä nälältä selvinnyt pala pedosta."
"[english]DOTA_Item_Desc_Dragonclaw_Hook"	"The claw from a black dragon's left toe. The only piece of the beast that survived an encounter with Pudge's voracious hunger."
"DOTA_Item_Demon_Blood_Helm"	"Demon Blood Helm"
"[english]DOTA_Item_Demon_Blood_Helm"	"Demon Blood Helm"
"DOTA_Item_Desc_Demon_Blood_Helm"	"Kypärä, joka kantaa Lammen sotureiden demonisen sotajumalan kasvonpiirteet. Huhu kertoo, että Punaisen usvan armeija tuhosi heidän jumalan ja otti symbolin omakseen."
"[english]DOTA_Item_Desc_Demon_Blood_Helm"	"A helm bearing the cyclopean visage of the Tarnsmen's demonic war god. It is said the Red Mist destroyed the god and took its symbols for their own."
"DOTA_Item_Desc_Demon_Blood_Armor"	"Tarnsmenien kuolleiden jumalten veressä taottu raskas levypanssari."
"[english]DOTA_Item_Desc_Demon_Blood_Armor"	"Heavy platemail forged in the blood of the Tarnsmen's dead gods."
"DOTA_Item_Demon_Blood_Guard"	"Demon Blood Guard"
"[english]DOTA_Item_Demon_Blood_Guard"	"Demon Blood Guard"
"DOTA_Item_Desc_Demon_Blood_Guard"	"Kun Punaisen usvan soturit kukistivat Tuhannen lammen armeijan, järvet värjäytyivät punaisiksi teurastettujen verestä. Tämän tuomitun kansakunnan demonit, jotka elivät kansakunnan pappeina ja lainjulistajina, tuhoutuivat myös, sekoittaen heidän verensä hallitsemiensa kuolevaisten kanssa."
"[english]DOTA_Item_Desc_Demon_Blood_Guard"	"When the Red Mist consumed the Thousand Tarns, the lakes turned red with the blood of the slain. Many demons masquerading as the lawmakers and priests of that doomed civilization were also destroyed, their blood mixing with that of the mortals they once ruled."
"DOTA_Item_Desc_Pegleg_of_the_Cursed_Pirate"	"Kadonnut jalka ei pidättele Kunkan kostonhalua."
"[english]DOTA_Item_Desc_Pegleg_of_the_Cursed_Pirate"	"A lost foot does not hinder Kunkka's desire for vengeance."
"DOTA_Item_Desc_SevenSealed_the_Fur_Bracer"	"Tuiki tavallinen, karvainen rannesuoja. Ei kovin omaperäinen, eikä sisällä taikuutta. Silti se kantaa suurta nimeä, kuvaten kuinka tyhjää perusteeton ylpeys voi olla."
"[english]DOTA_Item_Desc_SevenSealed_the_Fur_Bracer"	"This is merely a bracer of fur. It has no particular aspect of interest and offers no magical protections. Still, it bears a great name and in so doing illustrates the hollowness of baseless pride."
"DOTA_Item_Desc_FourFangs_the_Swordbreaker"	"Tämän miekan hampaat purevat syvälle vastustajasi aseeseen!"
"[english]DOTA_Item_Desc_FourFangs_the_Swordbreaker"	"The fangs of this fierce blade bite deep into your foe's bared weapon!"
"DOTA_Item_Desc_Pride_of_the_Crew"	"Jopa kapteenin täytyy antaa päivittäinen työpanoksensa laivan kannella miehistön tapaan."
"[english]DOTA_Item_Desc_Pride_of_the_Crew"	"Even the Captain must at times join his crew in the daily work aboard the ship."
"DOTA_Item_Desc_Royal_Admirals_Bicorne"	"Merikapteenin mainio kaksikolkka."
"[english]DOTA_Item_Desc_Royal_Admirals_Bicorne"	"A shipmaster's fine bicorne."
"DOTA_Item_Desc_Tricorne_of_the_Drowned"	"Taitavasti tehty kultareunainen kolmikulmihattu."
"[english]DOTA_Item_Desc_Tricorne_of_the_Drowned"	"A well crafted tricorne edged in gold."
"DOTA_Wearable_Kunkka_Wavecrester"	"Aallonmurtaja"
"[english]DOTA_Wearable_Kunkka_Wavecrester"	"Wavecrester"
"DOTA_Item_Desc_Wavecrester"	"Kunkan suvun perintökalleus, käyrä kulunut harppuuna."
"[english]DOTA_Item_Desc_Wavecrester"	"A weathered, hooked harpoon and heirloom of Kunkka's line."
"DOTA_Item_Desc_Berserkers_Pauldron"	"\"Niin monta pääkalloa vielä pilkottavana. Niin monta ruumista vielä heitettävänä pinoon.\""
"[english]DOTA_Item_Desc_Berserkers_Pauldron"	"\"So many skulls to cleave. So many bodies to throw on the pile.\""
"DOTA_Item_Desc_Berserkers_Helm"	"\"Sota on ainoa työni. Kuolema ainoa perheeni. Haudanrauha ainoa antamani armo!\""
"[english]DOTA_Item_Desc_Berserkers_Helm"	"\"No business but war. No family but death. No mercy but the grave!\""
"DOTA_Wearable_Axe_Berserkers_Belt"	"Raivohullun vyö"
"[english]DOTA_Wearable_Axe_Berserkers_Belt"	"Berserker's Belt"
"DOTA_Item_Desc_Berserkers_Belt"	"\"Verilöyly alkakoon.\""
"[english]DOTA_Item_Desc_Berserkers_Belt"	"\"Let the carnage begin.\""
"DOTA_Item_Coat_of_the_Elder_Grove"	"Coat of the Elder Grove"
"[english]DOTA_Item_Coat_of_the_Elder_Grove"	"Coat of the Elder Grove"
"DOTA_Item_Desc_Coat_of_the_Elder_Grove"	"Puunlehdistä punottu takki, tavallinen Verodician druidien keskuudessa, nyt saatavilla luonnon ikiomalle profeetalle."
"[english]DOTA_Item_Desc_Coat_of_the_Elder_Grove"	"A coat of leaves, common amongst the Druids of Verodicia, worn now by Nature's own prophet."
"DOTA_Item_Desc_Toga_of_the_PeaceBringer"	"Varsin rauhoittava."
"[english]DOTA_Item_Desc_Toga_of_the_PeaceBringer"	"Quite relaxing."
"DOTA_Item_Desc_Luxuriant_ChinFoliage"	"\"Antaa heidän, jotka vehreinä kuninkaina hallitsevat, kantaa otsallaan sarvia, jotka viisaudella ovat teroitetut, ja leuallaan roikottaa merkkiä, joka heidän asemastaan kertoo.\""
"[english]DOTA_Item_Desc_Luxuriant_ChinFoliage"	"\"Let those that would rule as Verdant Kings wear upon their brow horns sharpened with the wisdom of judgment and hang upon their chins a mighty symbol of their station.\""
"DOTA_Item_Desc_Horns_of_Noblesse"	"Kuninkaan arvoinen sarvipari."
"[english]DOTA_Item_Desc_Horns_of_Noblesse"	"A set of horns worthy of a king."
"DOTA_Item_Cape_of_Verdant_Dreaming"	"Cape of Verdant Dreaming"
"[english]DOTA_Item_Cape_of_Verdant_Dreaming"	"Cape of Verdant Dreaming"
"DOTA_Item_Desc_Cape_of_Verdant_Dreaming"	"Ikivanhojen metsien voimiin verhottu."
"[english]DOTA_Item_Desc_Cape_of_Verdant_Dreaming"	"Wrapped in the power of the ancient woods."
"DOTA_Item_Runestaff_of_Verodicia"	"Verodician riimusauva"
"[english]DOTA_Item_Runestaff_of_Verodicia"	"Runestaff of Verodicia"
"DOTA_Item_Desc_Prophets_Runestaff_of_Verodicia"	"Metsäjumalattaren salainen nimi loistaa tästä pyhästä sauvasta."
"[english]DOTA_Item_Desc_Prophets_Runestaff_of_Verodicia"	"The secret name of the woods-goddess shines from this holy staff."
"DOTA_Item_Desc_Runed_Ailettes"	"Näihin olkaimiin kaiverretut riimut antavat pukijalle voimia kantaa raskaimmatkin taakat."
"[english]DOTA_Item_Desc_Runed_Ailettes"	"The runes inscribed upon these shoulders give the wearer the strength to carry the heaviest burden."
"DOTA_Item_Desc_Lucky_Tooth_Necklace"	"Harvinaisen leviatanin hampaasta tehty kaulakoru."
"[english]DOTA_Item_Desc_Lucky_Tooth_Necklace"	"A necklace of rare leviathan's teeth."
"DOTA_Item_Captains_Hook"	"Kapteenin koukku"
"[english]DOTA_Item_Captains_Hook"	"Captain's Hook"
"DOTA_Item_Desc_Captains_Hook"	"Tärisevää saarta ympäröivät niin petolliset vedet, että siellä jopa kaikkein kokeneimmankin kapteenin loukkaantuminen on vain ajan kysymys."
"[english]DOTA_Item_Desc_Captains_Hook"	"In waters as treacherous as those that surround the Trembling Isle, it is inevitable that even the most skilled captain sustain injury."
"DOTA_Item_Desc_Tayrnhelm_of_the_Swordmaster"	"Sivuilla olevien korkeiden, sahalaitaisten tankojen sanotaan parantavan kuuloa."
"[english]DOTA_Item_Desc_Tayrnhelm_of_the_Swordmaster"	"The tall, serrated shafts along the side are said to improve hearing for the wearer."
"DOTA_Item_Desc_Fluted_Guard_of_the_Swordmaster"	"Tämän panssarin koolle ja painolle ilkuttiin, kunnes Sven käytti sen olkapiikkejä lävistääkseen Feral Roadin varrella kimppuunsa hyökänneen örkin."
"[english]DOTA_Item_Desc_Fluted_Guard_of_the_Swordmaster"	"The sheer size and weight of this piece were scoffed at until Sven used the shoulder spikes to impale an attacking ogre along the Feral Road."
"DOTA_Item_Desc_Meranth_Executioners_Blade"	"Yksiteräinen miekka, joka sopii täydellisesti päiden pikaiseen katkomiseen. Tai käsien. Tai jalkojen."
"[english]DOTA_Item_Desc_Meranth_Executioners_Blade"	"A single edged blade perfect for quickly removing heads. Or legs. Or arms."
"DOTA_Item_Taunt_Snipers_Celebration"	"Pilkka: Sniper karkeloi"
"[english]DOTA_Item_Taunt_Snipers_Celebration"	"Taunt: Sniper's Celebration"
"DOTA_AnimTaunt_SniperTaunt_Desc"	"Juhlista mehevää tappoa tai hyvin mennyttä peliä näyttämällä innokkuutesi vihollisellesi. Ei hän pistä pahakseen."
"[english]DOTA_AnimTaunt_SniperTaunt_Desc"	"Celebrate a sweet kill or a big play by showing your excitement to your enemy. He won't mind."
"DOTA_Item_Taunt_Beautiful_Snowangel"	"Pilkka: Kaunis lumienkeli"
"[english]DOTA_Item_Taunt_Beautiful_Snowangel"	"Taunt: Beautiful Snowangel"
"DOTA_AnimTaunt_CM_Snowangel_Desc"	"Crystal Maiden tekee lumienkelin!"
"[english]DOTA_AnimTaunt_CM_Snowangel_Desc"	"Crystal Maiden makes a snowangel!"
"DOTA_Item_Taunt_Playful_Snowball"	"Pilkka: Leikkisä lumipallo"
"[english]DOTA_Item_Taunt_Playful_Snowball"	"Taunt: Playful Snowball"
"DOTA_AnimTaunt_CM_Snowball_Desc"	"Crystal Maiden heittää lumipallon!"
"[english]DOTA_AnimTaunt_CM_Snowball_Desc"	"Crystal Maiden throws a snowball!"
"DOTA_Item_Taunt_Come_and_Get_It"	"Pilkka: Tule ottamaan!"
"[english]DOTA_Item_Taunt_Come_and_Get_It"	"Taunt: Come and Get It!"
"DOTA_Item_Desc_Taunt_Come_and_Get_It"	"Axe vaatii lisää hölmöjä lahdattavaksi!"
"[english]DOTA_Item_Desc_Taunt_Come_and_Get_It"	"Axe requests more fools to slaughter!"
"DOTA_AnimTaunt_Broodmother_Spin_Desc"	"Broodmotherin pyörähdyspilkka"
"[english]DOTA_AnimTaunt_Broodmother_Spin_Desc"	"Broodmother Spin Taunt"
"DOTA_Item_Taunt_Good_Day_Sir"	"Pilkka: Hyvää päivänjatkoa!"
"[english]DOTA_Item_Taunt_Good_Day_Sir"	"Taunt: Good Day Sir!"
"DOTA_Item_Desc_Taunt_Good_Day_Sir"	" "
"[english]DOTA_Item_Desc_Taunt_Good_Day_Sir"	""
"DOTA_Item_Taunt_DoubleHeaded_Roar"	"Pilkka: Kaksipäinen karjaisu"
"[english]DOTA_Item_Taunt_DoubleHeaded_Roar"	"Taunt: Double-Headed Roar"
"DOTA_AnimTaunt_Jakiro_Roar_Desc"	"Jakiron karjaisupilkka"
"[english]DOTA_AnimTaunt_Jakiro_Roar_Desc"	"Jakiro Roar Taunt"
"DOTA_Item_Taunt_Icemelter"	"Pilkka: Jäänsulattaja"
"[english]DOTA_Item_Taunt_Icemelter"	"Taunt: Icemelter"
"DOTA_AnimTaunt_Jakiro_Icemelt_Desc"	"Jakiron jäänsulatuspilkka"
"[english]DOTA_AnimTaunt_Jakiro_Icemelt_Desc"	"Jakiro Icemelt Taunt"
"DOTA_AnimTaunt_Tidehunter_Toss_Fish_Desc"	" "
"[english]DOTA_AnimTaunt_Tidehunter_Toss_Fish_Desc"	""
"DOTA_Item_Desc_Wrath_of_the_Orca"	"Esineellä ei ole vielä kuvausta."
"[english]DOTA_Item_Desc_Wrath_of_the_Orca"	"No description yet."
"DOTA_Item_Desc_Wuldastron_the_TwinBlade_of_Giants"	"Vain muutamat voivat nostaa näin mahtavaa asetta."
"[english]DOTA_Item_Desc_Wuldastron_the_TwinBlade_of_Giants"	"Few men could lift a blade so mighty."
"DOTA_Item_Attack_Fish_Slap"	"Hyökkäys: Kalaläimäytys"
"[english]DOTA_Item_Attack_Fish_Slap"	"Attack: Fish Slap"
"DOTA_Item_Desc_Attack_Fish_Slap"	"Antaa Tidehunterille erilaisen animaation perushyökkäykseen."
"[english]DOTA_Item_Desc_Attack_Fish_Slap"	"Gives Tidehunter an alternate default attack animation."
"DOTA_Item_Desc_Taunt__The_Jig"	"Witchdoctorin voitontanssipilkka."
"[english]DOTA_Item_Desc_Taunt__The_Jig"	"Witchdoctor Victory Dance Taunt."
"DOTA_Item_Taunt_You"	"Pilkka: Sinä!"
"[english]DOTA_Item_Taunt_You"	"Taunt: You!"
"DOTA_Item_Taunt_Dive_Dive"	"Pilkka: Sukella! Sukella!"
"[english]DOTA_Item_Taunt_Dive_Dive"	"Taunt: Dive! Dive!"
"DOTA_Item_Desc_Taunt_Natures_Prophets_Bazooka"	"Tämä *on* hänen sauvansa, ja hän on iloissaan siitä, että tappoi sinut!"
"[english]DOTA_Item_Desc_Taunt_Natures_Prophets_Bazooka"	"That *is* his staff and he's excited to have killed you!"
"DOTA_Item_Taunt_Shredding_the_Lute_Invisible"	"Pilkka: Ilmaluuttu"
"[english]DOTA_Item_Taunt_Shredding_the_Lute_Invisible"	"Taunt: Shredding the Lute Invisible"
"DOTA_Item_Desc_Taunt_For_Death_and_Honor"	"Osoita kunnioituksesi viholliselle heidän kunniallista kuolemaansa kohtaan."
"[english]DOTA_Item_Desc_Taunt_For_Death_and_Honor"	"Show your enemy your respect for their honorable deaths."
"DOTA_Item_Taunt_Face_the_Juggernaut"	"Pilkka: Kohtaa Juggernaut"
"[english]DOTA_Item_Taunt_Face_the_Juggernaut"	"Taunt: Face the Juggernaut"
"DOTA_Item_Desc_Taunt_Face_the_Juggernaut"	"Kutsu vihollisesi kuolemaan kunniakkaassa taistelussa."
"[english]DOTA_Item_Desc_Taunt_Face_the_Juggernaut"	"Invite your enemy to embrace their death in honorable combat."
"DOTA_Item_Desc_Taunt_Tooting_the_Horn"	"Tee kunniaa vihollisen kuolemalle."
"[english]DOTA_Item_Desc_Taunt_Tooting_the_Horn"	"Salute the death of your enemy."
"DOTA_Item_Desc_Prophets_Staff_of_the_Violators"	"Kuulkaa te, jotka teroitatte torahampaitanne puunrunkoihin!"
"[english]DOTA_Item_Desc_Prophets_Staff_of_the_Violators"	"Let those who would sharpen their tusks on woodsy trunks take heed!"
"DOTA_Item_Desc_Grand_Crown_of_the_Gigas"	"Onko uljaampaa petoa kuin mahtava Gigas? Jopa alcet ja cameloidit kumartavat sen edessä."
"[english]DOTA_Item_Desc_Grand_Crown_of_the_Gigas"	"Is there any beast more majestic than the mighty Gigas? Even Alces and Cameloides bow before it."
"DOTA_Item_Desc_Sinorian_Sphere_Staff"	"Kärjessä on Sinorialainen jalokivi, joka toimii maagisena polttopisteenä luonnon loitsuille."
"[english]DOTA_Item_Desc_Sinorian_Sphere_Staff"	"A Sinorian gemstone caps this staff, providing a magical focus for nature's incantations."
"DOTA_Item_Taunt_Murder_Lute"	"Pilkka: Murhaluuttu"
"[english]DOTA_Item_Taunt_Murder_Lute"	"Taunt: Murder Lute"
"DOTA_Item_Desc_Twin_Bull_Adornment"	"Verodician valtakunnan otuksista zebut ja aurokit tiedetään ylpeimmiksi."
"[english]DOTA_Item_Desc_Twin_Bull_Adornment"	"Among the myriad creatures of Verodicia's domain, the zebu and the aurochs stand as the most prideful."
"DOTA_Item_Pauldron_of_AlFusha"	"Pauldron of Al-Fusha"
"[english]DOTA_Item_Pauldron_of_AlFusha"	"Pauldron of Al-Fusha"
"DOTA_Item_Desc_Pauldron_of_AlFusha"	"Al-Fusha oli suuri satyyrikenraali Verodician palveluksessa. Suuri osa hänen varusteistaan katosi hänen kaaduttuaan taistelussa. Nämä piikikkäät ja jumalattaren siunaamat olkasuojat ovat yhä tallella."
"[english]DOTA_Item_Desc_Pauldron_of_AlFusha"	"Al-Fusha was a great satyr general in service to Verodicia. It is said that he fell in battle and much of his wargear lost. Of it, this spiked and goddess-blessed pauldron remains."
"DOTA_Item_Castors_Spaulder"	"Castor's Spaulder"
"[english]DOTA_Item_Castors_Spaulder"	"Castor's Spaulder"
"DOTA_Item_Desc_Castors_Spaulder"	"Jokimaiden sankari Castor Twin-Tusks haastoi Verodician valitseman profeetan maagien kaksintaistoon. Hän hävisi."
"[english]DOTA_Item_Desc_Castors_Spaulder"	"The riverlands hero Castor Twin-Tusks challenged Verodicia's chosen prophet to an arcane duel. He lost."
"DOTA_Item_Defender_of_the_Ivory_Isles"	"Norsunluusaarten puolustaja"
"[english]DOTA_Item_Defender_of_the_Ivory_Isles"	"Defender of the Ivory Isles"
"DOTA_Item_Curled_RootStaff"	"Kiertynyt juurikeppi"
"[english]DOTA_Item_Curled_RootStaff"	"Curled Root-Staff"
"DOTA_Item_Flared_Wooden_Crest"	"Flared Wooden Crest"
"[english]DOTA_Item_Flared_Wooden_Crest"	"Flared Wooden Crest"
"DOTA_Item_Desc_Fireborn_Odachi"	"Taottiin tulessa joka kupli ylös merestä sinä yönä, jolloin kotimaasi uppoutui aaltojen alle!"
"[english]DOTA_Item_Desc_Fireborn_Odachi"	"Forged in the fires that bubbled up from the sea on the night your homeland sank beneath the waves!"
"DOTA_Item_Desc_Taunt_Kata_of_Foot_and_Earth"	"Esittele kamppailulajitaitojasi tällä katalla."
"[english]DOTA_Item_Desc_Taunt_Kata_of_Foot_and_Earth"	"Demonstrate your martial skill with this kata."
"DOTA_Item_Doubly_Braided_Beard"	"Doubly Braided Beard"
"[english]DOTA_Item_Doubly_Braided_Beard"	"Doubly Braided Beard"
"DOTA_Item_Desc_Doubly_Braided_Beard"	"Mahtavan luonnonvoiman ei pitäisi tyytyä vain yhteen partaan."
"[english]DOTA_Item_Desc_Doubly_Braided_Beard"	"A force as mighty as nature itself should not be content with merely one beard."
"DOTA_Item_Druidic_Ritual_Crest"	"Druidic Ritual Crest"
"[english]DOTA_Item_Druidic_Ritual_Crest"	"Druidic Ritual Crest"
"DOTA_Item_Wolf_Cape_of_the_High_Plains"	"Wolf Cape of the High Plains"
"[english]DOTA_Item_Wolf_Cape_of_the_High_Plains"	"Wolf Cape of the High Plains"
"DOTA_Item_Aspect_Wraps_of_the_High_Plains"	"Aspect Wraps of the High Plains"
"[english]DOTA_Item_Aspect_Wraps_of_the_High_Plains"	"Aspect Wraps of the High Plains"
"DOTA_Item_LongFang_the_Grey_Blade"	"Long-Fang the Grey Blade"
"[english]DOTA_Item_LongFang_the_Grey_Blade"	"Long-Fang the Grey Blade"
"DOTA_Item_Beard_of_Cycles"	"Beard of Cycles"
"[english]DOTA_Item_Beard_of_Cycles"	"Beard of Cycles"
"DOTA_Item_Diadem_of_the_Goddess_Enthroned"	"Diadem of the Goddess Enthroned"
"[english]DOTA_Item_Diadem_of_the_Goddess_Enthroned"	"Diadem of the Goddess Enthroned"
"DOTA_Item_Desc_Diadem_of_the_Goddess_Enthroned"	"Kunnia hänelle joka tuo tuulen ja sen muassa elämän esanssin!"
"[english]DOTA_Item_Desc_Diadem_of_the_Goddess_Enthroned"	"Glory to her that brings the wind and upon it life's essence!"
"DOTA_Item_Drape_of_Foliate_Magery"	"Drape of Foliate Magery"
"[english]DOTA_Item_Drape_of_Foliate_Magery"	"Drape of Foliate Magery"
"DOTA_Item_Guard_of_the_Deep_Tribes"	"Guard of the Deep Tribes"
"[english]DOTA_Item_Guard_of_the_Deep_Tribes"	"Guard of the Deep Tribes"
"DOTA_Item_PineSage_Sigil_Stones"	"Pine-Sage Sigil Stones"
"[english]DOTA_Item_PineSage_Sigil_Stones"	"Pine-Sage Sigil Stones"
"DOTA_Item_Cuffs_of_Oak_and_Yew"	"Cuffs of Oak and Yew"
"[english]DOTA_Item_Cuffs_of_Oak_and_Yew"	"Cuffs of Oak and Yew"
"DOTA_Item_Desc_Octopus_Hat"	"Yrittääkä se liftata kyydin? Yrittääkö se paritella hänen päänsä kanssa? Luuleeko se pystyvänsä vaikuttamaan Tidehunterin ajatuksiin? Ken tietää!"
"[english]DOTA_Item_Desc_Octopus_Hat"	"Is it trying to hitch a ride?  Is it trying to mate with his head?  Does it think it can influence the Tidehunter's thoughts?  Who knows!"
"DOTA_Item_Grand_Claive_of_the_Unshamed"	"Grand Claive of the Unshamed"
"[english]DOTA_Item_Grand_Claive_of_the_Unshamed"	"Grand Claive of the Unshamed"
"DOTA_Item_Wyrm_Shield_of_Uldorak"	"Wyrm Shield of Uldorak"
"[english]DOTA_Item_Wyrm_Shield_of_Uldorak"	"Wyrm Shield of Uldorak"
"DOTA_Item_Desc_Wyrm_Shield_of_Uldorak"	"Dragon Knight kantoi tätä kilpeä sinä päivänä, jona hän kohtasi ja surmasi Time-Dragon Uldorakin."
"[english]DOTA_Item_Desc_Wyrm_Shield_of_Uldorak"	"The Dragon Knight bore this shield the day he fought and slew the Time Dragon Uldorak."
"DOTA_Item_Belt_o_Wicked_Badness"	"Belt o' Wicked Badness"
"[english]DOTA_Item_Belt_o_Wicked_Badness"	"Belt o' Wicked Badness"
"DOTA_Item_Desc_Belt_o_Wicked_Badness"	"Witch Doctorin heimoesi-isien pääkallot komistavat tätä vyötä."
"[english]DOTA_Item_Desc_Belt_o_Wicked_Badness"	"The skulls of the Witch Doctor's tribal ancestors adorn this belt."
"DOTA_Item_Kimono_of_the_Ebony_Tower"	"Kimono of the Ebony Tower"
"[english]DOTA_Item_Kimono_of_the_Ebony_Tower"	"Kimono of the Ebony Tower"
"DOTA_Item_Bracers_of_the_Ebony_Tower"	"Bracers of the Ebony Tower"
"[english]DOTA_Item_Bracers_of_the_Ebony_Tower"	"Bracers of the Ebony Tower"
"DOTA_Item_Relic_Blade_of_the_KuurIshiminari"	"Relic Blade of the Kuur-Ishiminari"
"[english]DOTA_Item_Relic_Blade_of_the_KuurIshiminari"	"Relic Blade of the Kuur-Ishiminari"
"DOTA_Item_Desc_100Proof_Jug"	"Rohkeus saattaa olla peräisin pelottomasta käytöksestä tai taidokkaasta miekkakädesta. Niitä varten, joilta nuo ominaisuudet puuttuvat, on aina olemassa pullo ja kannu."
"[english]DOTA_Item_Desc_100Proof_Jug"	"Courage may be born of a fearless demeanor or a masterful blade-arm. For those who lack these things, there is always the bottle and the jug."
"DOTA_Item_Desc_Blade_of_the_Dark_Ancients"	"Kidutettujen jumalten sirpaloituneet sielut majailevat obsidiaanimiekan sisässä."
"[english]DOTA_Item_Desc_Blade_of_the_Dark_Ancients"	"The fragmented souls of tormented gods dwell within the blade's obsidian form."
"DOTA_Item_Desc_Wyrm_Helm_of_Uldorak"	"Vuosia ennen kohtalokasta yhteenottoaan Eldwurmin kanssa Dragon Knight kohtasi ja surmasi Time-Dragon Uldorakin. Helpottunut vastakruunattu kuningas Tansis XIII antoi takoa tämän kypärän lahjaksi ja palkkioksi."
"[english]DOTA_Item_Desc_Wyrm_Helm_of_Uldorak"	"Many years before his fateful encounter with the Eldwurm, the Dragon Knight battled with and slew the Time-Dragon Uldorak. The much relieved and newly crowned King Tansis XIII ordered this helm forged as a gift and reward."
"DOTA_Item_Desc_BackAche"	"Harvinainen mutta hyödyllinen mutaatio. Piikit ovat tosiasiassa epämuodostuneite hampaita, jotka kasvoivat väärään paikkaan."
"[english]DOTA_Item_Desc_BackAche"	"A rare but useful mutation.  The spikes are actually malformed teeth that grew out of place, and well out of hand."
"DOTA_Item_Desc_Excavators_Treasure"	"Syvyyksistä pimeimmät kätkevät sisäänsä monen sukupuuttoon kuolleen kallot."
"[english]DOTA_Item_Desc_Excavators_Treasure"	"The darkest deeps hold many extinct skulls."
"DOTA_Item_Naval_Mine"	"Naval Mine"
"[english]DOTA_Item_Naval_Mine"	"Naval Mine"
"DOTA_Item_Desc_Naval_Mine"	"Kun se putosi syvyyksiin ja rikkoi yhden hänen lempikoralliriutoistaan, Tidehunter vannoi palauttavansa kapistuksen takaisin omistajalleen."
"[english]DOTA_Item_Desc_Naval_Mine"	"When it fell to the depths and smashed a favorite coral bed, the Tidehunter swore to reunite the device with its owner."
"DOTA_Item_Pillar_of_Strength"	"Pillar of Strength"
"[english]DOTA_Item_Pillar_of_Strength"	"Pillar of Strength"
"DOTA_Item_Desc_Pillar_of_Strength"	"Axe vähät välittää vihollistensa suurista linnoista ja mahtavista palatseista. Hän pirstoo niiden paalut ja murskaa pylväät, ja muuttaa rauniot aseiksi itselleen."
"[english]DOTA_Item_Desc_Pillar_of_Strength"	"Axe cares nothing for the great castles and mighty holds of his enemies. He shatters their stanchions and crumbles their columns, transforming the rubble into weapons of war."
"DOTA_Item_Desc_Stone_Loins"	"Axen kaltainen suurikokoinen soturi löytää harvoin päälleen sopivaa panssaria. Usein osoittautuukin kätevämmäksi vain sitoa yhteen kiven- ja metallinpalasia."
"[english]DOTA_Item_Desc_Stone_Loins"	"A warrior as large as Axe rarely finds armor that fits. Often it is more practical to simply tie together bits of stone and metal."
"DOTA_Item_Stone_Helmet"	"Stone Helmet"
"[english]DOTA_Item_Stone_Helmet"	"Stone Helmet"
"DOTA_Item_Desc_Raw_Hide"	"Parhainkin uija voi yllättyä."
"[english]DOTA_Item_Desc_Raw_Hide"	"Even the best swimmer may be caught unaware."
"DOTA_Item_Desc_Femur_Thrasher"	"Terävä, murtunut reisiluu jostain tunnistamattomasta meripedosta."
"[english]DOTA_Item_Desc_Femur_Thrasher"	"A sharp, cracked femur of some unidentifiable sea-beast."
"DOTA_Item_Desc_Mask_of_the_Freelancer"	"Tämä gladiaattorimainen kypärä palvelee Sveniä hyvin hänen matkatessaan etsimään kunniaa ja kultaa."
"[english]DOTA_Item_Desc_Mask_of_the_Freelancer"	"This old gladiatorial helm serves Sven well as he travels the land in search of honor and gold."
"DOTA_Item_Desc_Shoulderguard_of_the_Freelancer"	"Yksinäisten miekkamiesten täytyy tasapainottaa suojauksensa ja nopeutensa. Tämä olkapanssari suojaa vain Svenin hartian toista puolta, jättäen toisen puolen kevyemmäksi."
"[english]DOTA_Item_Desc_Shoulderguard_of_the_Freelancer"	"Rogue swordmasters must balance the need for protection with the need for speed. This pauldron protects Sven's leading shoulder, but leaves his back arm unencumbered."
"DOTA_Item_Desc_Pantaloons_of_the_Freelancer"	"Nämä koreat housut osoittavat että Svenin retket ovat tuottaneet yhtä paljon kultaa kuin kunniaakin."
"[english]DOTA_Item_Desc_Pantaloons_of_the_Freelancer"	"These fine pantaloons show that Sven's travels have led him into gold as much as glory."
"DOTA_Item_Desc_Sword_of_the_Freelancer"	"\"Katkera on orvon matka--ja yksinäinen hänen hautansa.\""
"[english]DOTA_Item_Desc_Sword_of_the_Freelancer"	"\"Bitter the orphans journey--and lonely the orphan's grave.\""
"DOTA_Item_Dragonmaw"	"Lohikäärmeenkita"
"[english]DOTA_Item_Dragonmaw"	"Dragonmaw"
"DOTA_Item_Desc_Squiddles"	"Sangen ylimitoitettu, täytetty kalmaripehmo. Hän on söpö ja limainen ja hänen nimensä on Kalmarinen."
"[english]DOTA_Item_Desc_Squiddles"	"A rather oversized, stuffed squid plushie. He's cute and slimy and his name is Squiddles."
"DOTA_Item_Desc_Executioners_Cape"	"Raskas, mustaksi värjätty villaviitta. Se saa jopan Axen näyttämään hiipparilta."
"[english]DOTA_Item_Desc_Executioners_Cape"	"A heavy woolen cloak dyed black. It could make even Axe seem stealthy."
"DOTA_Item_Desc_Executioners_Hood"	"Axen työ on synkkää ja loputonta."
"[english]DOTA_Item_Desc_Executioners_Hood"	"The work of the Axe is grim and endless."
"DOTA_Item_Desc_SeaGods_Ceremonial_Headdress"	"Tällä uudella esineellä ei ole kuvausta."
"[english]DOTA_Item_Desc_SeaGods_Ceremonial_Headdress"	"This new item has no description."
"DOTA_Item_Desc_Cleaver_of_the_Hidden_Hunter"	"Jo valmiiksi raskas terä, jonka päähän upotettu painava rengas tekee vielä painavammaksi. Tämä ase ei sovellu kevyeen käyttöön, vaan viemään vastustajalta pää yhdellä iskulla."
"[english]DOTA_Item_Desc_Cleaver_of_the_Hidden_Hunter"	"An already heavy blade, made even heavier by the weighted ring looped through the top. This is not a weapon for finesse, but for taking the enemy's head in a single strike."
"DOTA_Item_Desc_Blacksmiths_Apron"	"Siihen on kuolleella kielellä kirjoitettu sanat \"Suutele kirvestä.\""
"[english]DOTA_Item_Desc_Blacksmiths_Apron"	"Written upon it a lost language are the words, \"Kiss the axe.\""
"DOTA_Item_Desc_Forgemasters_Hammer"	"Ainoa päivä, jona Axe myöns tappionsa oli se, jona hän yritti takoa asetta kirveellään."
"[english]DOTA_Item_Desc_Forgemasters_Hammer"	"The only day Axe declared defeat was the day he tried to forge a weapon with an axe."
"DOTA_Item_Desc_Chronite_Scepter"	"Mahdin symboli Claszuremen päättymättömissä saleissa."
"[english]DOTA_Item_Desc_Chronite_Scepter"	"A symbol of power within the infinite halls of Claszureme."
"DOTA_Item_Desc_Ice_Burst_Bracers"	"Koostaan huolimatta nämä terävät, jäänkaltaiset kristallit ovat liki painottomia eivätkä näin haittaa Drow Rangerin jousen käyttöä."
"[english]DOTA_Item_Desc_Ice_Burst_Bracers"	"Despite their size, these sharp ice-like crystals weigh almost nothing and so do not hinder the Drow Ranger's use of the bow."
"DOTA_Item_Desc_Creepers_Cruel_Hook"	"Kulta on vain yksi syy, miksi Gondar metsästää."
"[english]DOTA_Item_Desc_Creepers_Cruel_Hook"	"Gold is only one reason why Gondar hunts."
"DOTA_Item_Desc_Creepers_Cruel_Shuriken"	"\"Auts!\""
"[english]DOTA_Item_Desc_Creepers_Cruel_Shuriken"	"'Ouch!'"
"DOTA_Item_Desc_Pirate_Slayers_Cutlass"	"Epäonnisen merikapteenin pääkallo koristaa tätä ruosteista miekkaa."
"[english]DOTA_Item_Desc_Pirate_Slayers_Cutlass"	"The skull of an unfortunate sea captain adorns this rusty blade."
"DOTA_Item_Desc_Pirate_Slayers_Black_Flag"	"Kerran niin kauhistuttavan symbolin jääneet todistavat nyt Tidehunterin voimaa."
"[english]DOTA_Item_Desc_Pirate_Slayers_Black_Flag"	"The remains of a once terrible icon, now a symbol of the Tidehunter's power."
"DOTA_Item_Desc_War_Blade_Left"	"Poikkeuksellisen pureva sotaterä."
"[english]DOTA_Item_Desc_War_Blade_Left"	"An exceptionally sharp war-blade."
"DOTA_Item_Desc_Head_Crusher"	"Harvalle on suotu voimia nostaa näin massiivista sotavasaraa."
"[english]DOTA_Item_Desc_Head_Crusher"	"Few men are endowed with the strength to lift such a massive battle hammer."
"DOTA_Item_Back_Hook_Right"	"Back Hook"
"[english]DOTA_Item_Back_Hook_Right"	"Back Hook"
"DOTA_Item_Back_Hook_Left"	"Back Hook (Vasen)"
"[english]DOTA_Item_Back_Hook_Left"	"Back Hook (Left)"
"DOTA_Item_Desc_Witch_Doctors_Vile_Hat"	"Tällä uudella esineellä ei ole kuvausta."
"[english]DOTA_Item_Desc_Witch_Doctors_Vile_Hat"	"This new item has no description."
"DOTA_Item_Desc_Horns_of_the_PeaceBringer"	"Rauhanmerkin muotoon kaartuneet sarvet."
"[english]DOTA_Item_Desc_Horns_of_the_PeaceBringer"	"Horns curved into a sigil of peace."
"DOTA_Item_Beard_of_the_PeaceBringer"	"Sovittelijan parta"
"[english]DOTA_Item_Beard_of_the_PeaceBringer"	"Beard of the Peace-Bringer"
"DOTA_Item_Desc_Beard_of_the_PeaceBringer"	"Kevyt ja pörheä."
"[english]DOTA_Item_Desc_Beard_of_the_PeaceBringer"	"Light and fluffy."
"DOTA_Item_Desc_Bracer_of_the_Burning_Cabal"	"Tulielementtien manipulointi vaatii hienovaraista otetta, jotta loitsija ei itse palaisi. Nämä rannesuojat ovat lumottu antamaan vähäistä suojaa tulta vastaan."
"[english]DOTA_Item_Desc_Bracer_of_the_Burning_Cabal"	"Manipulation of the fire elements requires a delicate touch, lest the sorcerer burn. This pair of bracers have been imbued with minor fire protection enchantments."
"DOTA_Item_Desc_Stylish_Wizards_Topnot"	"Harvaa velhoa voi kutsua tyylikkääksi, mutta Invoker ei ole muiden velhojen kaltainen."
"[english]DOTA_Item_Desc_Stylish_Wizards_Topnot"	"Few wizards can be considered to be stylish, but the Invoker is not like other wizards."
"DOTA_Trial_UpgradeItem"	"Dota 2 kokeiluversion päivitysesine"
"[english]DOTA_Trial_UpgradeItem"	"Dota 2 Trial Upgrade Item"
"DOTA_VoiceTaunt_InTheBag_Desc"	"Osoita itsevarmuutesi vastapuolelle. Mikään ei taatusti mene vikaan..."
"[english]DOTA_VoiceTaunt_InTheBag_Desc"	"Express your confidence to the enemy team. Surely nothing could possibly go wrong..."
"DOTA_Custom_Courier_Sheep"	"Lammaskuriiri"
"[english]DOTA_Custom_Courier_Sheep"	"Sheep Courier"
"DOTA_Custom_Courier_Sheep_Desc"	"Lammaskuriirin kuvaus! Lol! Tyhjää täynnä!"
"[english]DOTA_Custom_Courier_Sheep_Desc"	"Sheep Courier description field! Lawls! No text!"
"DOTA_Custom_HexModel_Frog"	"Sammakkosaneeraus"
"[english]DOTA_Custom_HexModel_Frog"	"Amphibian Alteration"
"DOTA_Custom_HexModel_Frog_Desc"	"Muunnos klassisesta suovelhojen ja noitien suosimasta muodonmuutosloitsusta.
Käyttöön otettuna korvaa loitsueläimesi sammakolla."
"[english]DOTA_Custom_HexModel_Frog_Desc"	"A variation on the classic polymorphic hex favored by swamp wizards and spurned witches.
When equipped, this item replaces your hex animal with a frog."
"DOTA_Custom_HexModel_Cheese"	"Polymorfinen pastörointi"
"[english]DOTA_Custom_HexModel_Cheese"	"Polymorphic Pasteurization"
"DOTA_Custom_HexModel_Cheese_Desc"	"Harvinaisen haiseva muodonmuutos. Sen suunnitteli kääpiö, joka käytti taikasepän taitojaan kopioimaan örkkiläisen sinihomejuuston aromin.
Käyttöön otettuna tämä esine korvaa loitsueläimesi juustonpalasella."
"[english]DOTA_Custom_HexModel_Cheese_Desc"	"A particularly smelly shape change designed by a Dwarven spellsmith with a taste for Orcish Bleu.
When equipped, this item replaces your hex animal with a piece of cheese."
"DOTA_Custom_Courier_ShittyWizard"	"Surkea velho"
"[english]DOTA_Custom_Courier_ShittyWizard"	"Shitty Wizard"
"DOTA_Custom_Courier_ShittyWizard_Desc"	"on surkea"
"[english]DOTA_Custom_Courier_ShittyWizard_Desc"	""
"DOTA_Custom_Courier_MiniPudge"	"Minipudgekuriiri"
"[english]DOTA_Custom_Courier_MiniPudge"	"Minipudge Courier"
"DOTA_Custom_Courier_MiniPudge_Desc"	" "
"[english]DOTA_Custom_Courier_MiniPudge_Desc"	""
"DOTA_Item_Announcer_Dr_Kleiner"	"Kuuluttaja: Tohtori Kleiner"
"[english]DOTA_Item_Announcer_Dr_Kleiner"	"Announcer: Dr. Kleiner"
"DOTA_Item_Desc_Announcer_Dr_Kleiner"	"Tämä esine korvaa oletuskuuluttajan tohtori Kleinerin terävällä mielellä."
"[english]DOTA_Item_Desc_Announcer_Dr_Kleiner"	"This item replaces the Default announcer with the sharp mind of science's Dr. Kleiner."
"DOTA_Item_Desc_Copy_of_Minipudge_Courier"	" "
"[english]DOTA_Item_Desc_Copy_of_Minipudge_Courier"	""
"DOTA_Item_Announcer_Juggernaut"	"Kuuluttaja: Juggernaut"
"[english]DOTA_Item_Announcer_Juggernaut"	"Announcer: Juggernaut"
"DOTA_Item_Desc_Announcer_Juggernaut"	"Tämä esine korvaa oletuskuuluttajan vaeltavan soturin, Juggernautin, tarkasti valituilla sanoilla."
"[english]DOTA_Item_Desc_Announcer_Juggernaut"	"This item replaces the Default announcer with the carefully chosen words of the traveling warrior, Juggernaut."
"DOTA_Item_Announcer_Natures_Prophet"	"Kuuluttaja: Nature's Prophet"
"[english]DOTA_Item_Announcer_Natures_Prophet"	"Announcer: Nature's Prophet"
"DOTA_Item_Desc_Announcer_Natures_Prophet"	"Tämä esine korvaa oletuskuuluttajan Nature's Prophetin tuimalla äänellä."
"[english]DOTA_Item_Desc_Announcer_Natures_Prophet"	"This item replaces the Default announcer with the stern voice of Nature's Prophet."
"DOTA_Item_Treasure_Chest"	" "
"[english]DOTA_Item_Treasure_Chest"	""
"DOTA_TreasureChest_Rare"	" "
"[english]DOTA_TreasureChest_Rare"	""
"DOTA_TreasureChest_Desc"	" "
"[english]DOTA_TreasureChest_Desc"	""
"DOTA_Item_Desc_Tickled_Tegu"	"Kesy lisko lohikäärmeiden asuttamasta Cathauranin erämaasta. Se hymyilee ihan kuin se tietäisi jotain mitä sinä et."
"[english]DOTA_Item_Desc_Tickled_Tegu"	"A friendly Tegu from the dragon infested Cathauran Wastes. He smiles as if he knows something you do not."
"DOTA_Item_Desc_Mighty_Boar"	"Tällä karjulla on hullunkiilto silmissä. Kertooko se epäluottamuksesta? Hulluudesta? Vai haluaako se vain syödä tangosi."
"[english]DOTA_Item_Desc_Mighty_Boar"	"This boar has a crazed look in his eye. Is it distrust? Madness? Or does he just want to eat your tangos."
"DOTA_Item_Desc_Name_Tag"	"Käytä tätä työkalua repussasi olevaan esineeseen ja anna sille <font color='#9da1a9'>muokattu nimi</font> tuplaklikkaamalla tai klikkaamalla sitä hiiren oikealla näppäimellä. Nimitunnisteet ovat kertakäyttöisiä esineitä. Nimetty esine voidaan palauttaa alkuperäiseen tilaansa klikkaamalla sitä repussa hiiren oikealla näppäimellä ja painamalla 'Palauta'-asetusta."
"[english]DOTA_Item_Desc_Name_Tag"	"Double or right-click this tool and use it on an item in your backpack to give the item a <font color='#9da1a9'>customized name</font>.
	Name Tags are consumable items, and may only be used once. A named item can be reverted to its original state by right-clicking the item in the backpack and pressing the 'Restore' option."
"DOTA_Item_Desc_Tag"	"Kuvaustunniste"
"[english]DOTA_Item_Desc_Tag"	"Description Tag"
"DOTA_Item_Desc_Desc_Tag"	"Käytä tätä työkalua repussasi olevaan esineeseen antaaksesi sille <font color='#9da1a9'>muokatun kuvauksen</font> tuplaklikkaamalla tai klikkaamalla sitä hiiren oikealla näppäimellä. Kuvaustunnisteet ovat kertakäyttöisiä esineitä. Uuden kuvauksen saanut esine voidaan palauttaa alkuperäiseen tilaansa klikkaamalla sitä repussa hiiren oikealla näppäimellä ja painamalla 'Palauta'-asetusta."
"[english]DOTA_Item_Desc_Desc_Tag"	"Double or right-click this tool and use it on an item in your backpack to give the item a <font color='#9da1a9'>customized description</font>.
	Description Tags are consumable items, and may only be used once. A described item can be reverted to its original state by right-clicking the item in the backpack and pressing the 'Restore' option."
"DOTA_Item_Backpack_Expander"	"Repunlaajennin"
"[english]DOTA_Item_Backpack_Expander"	"Backpack Expander"
"DOTA_Item_75_Battle_Point_Booster_3_Days"	"75% Taistelubonus (3 päivää)"
"[english]DOTA_Item_75_Battle_Point_Booster_3_Days"	"75% Battle Point Booster (3 Days)"
"DOTA_Item_75_Battle_Point_Booster_6_Days"	"75% Taistelubonus (6 päivää)"
"[english]DOTA_Item_75_Battle_Point_Booster_6_Days"	"75% Battle Point Booster (6 Days)"
"DOTA_Item_LeagueViewPass"	"League View Test"
"[english]DOTA_Item_LeagueViewPass"	"League View Test"
"DOTA_Item_Desc_LeagueViewPass"	" "
"[english]DOTA_Item_Desc_LeagueViewPass"	"League View Test"
"DOTA_Bundle_DOTA2_Access"	"Dota 2 -kutsu"
"[english]DOTA_Bundle_DOTA2_Access"	"Dota 2 Invite"
"DOTA_Item_International_2012_Ticket"	"International 2012 -lippu"
"[english]DOTA_Item_International_2012_Ticket"	"International 2012 Ticket"
"DOTA_WearableType_Helmet"	"kypärä"
"[english]DOTA_WearableType_Helmet"	"helmet"
"DOTA_WearableType_Misc"	"Muu"
"[english]DOTA_WearableType_Misc"	"Misc"
"DOTA_WearableType_Snake_Charm"	"käärmeriipus"
"[english]DOTA_WearableType_Snake_Charm"	"Snake Charm"
"DOTA_WearableType_Strange_Modifier"	"Kummallinen muuntaja"
"[english]DOTA_WearableType_Strange_Modifier"	"Strange Modifier"
"DOTA_WearableType_TournamentTicket"	"turnauslippu"
"[english]DOTA_WearableType_TournamentTicket"	"Tournament Ticket"
"DOTA_Item_Phantom_Assassins_Helmet"	"Phantom Assassinin kypärä"
"[english]DOTA_Item_Phantom_Assassins_Helmet"	"Phantom Assassin's Helmet"
"DOTA_Item_Desc_Phantom_Assassins_Helmet"	"Tällä uudella esineellä ei ole kuvausta."
"[english]DOTA_Item_Desc_Phantom_Assassins_Helmet"	"This new item has no description."
"DOTA_Item_Desc_Copy_of_Phantom_Assassins_Helmet"	"Tällä uudella esineellä ei ole kuvausta."
"[english]DOTA_Item_Desc_Copy_of_Phantom_Assassins_Helmet"	"This new item has no description."
"DOTA_Item_Phantom_Assassins_Cape"	"Phantom Assassinin viitta"
"[english]DOTA_Item_Phantom_Assassins_Cape"	"Phantom Assassin's Cape"
"DOTA_Item_Desc_Copy_of_Phantom_Assassins_Shoulder_Pads"	"Tällä uudella esineellä ei ole kuvausta."
"[english]DOTA_Item_Desc_Copy_of_Phantom_Assassins_Shoulder_Pads"	"This new item has no description."
"DOTA_Item_Phantom_Assassins_Weapon"	"Phantom Assassinin ase"
"[english]DOTA_Item_Phantom_Assassins_Weapon"	"Phantom Assassin's Weapon"
"DOTA_Item_Desc_Copy_of_Phantom_Assassins_Cape"	"Tällä uudella esineellä ei ole kuvausta."
"[english]DOTA_Item_Desc_Copy_of_Phantom_Assassins_Cape"	"This new item has no description."
"DOTA_Item_Phantom_Assassins_Daggers"	"Phantom Assassinin tikarit"
"[english]DOTA_Item_Phantom_Assassins_Daggers"	"Phantom Assassin's Daggers"
"DOTA_Item_Desc_Phantom_Assassins_Daggers"	"Tällä uudella esineellä ei ole kuvausta."
"[english]DOTA_Item_Desc_Phantom_Assassins_Daggers"	"This new item has no description."
"DOTA_Item_Desc_Ol_Snaggletooth"	"Witch Doctor löysi tämän tyylikkään krokoleuan puskaan hylättynä."
"[english]DOTA_Item_Desc_Ol_Snaggletooth"	"Witch Doctor found this stylish croc jaw discarded in the bush."
"DOTA_Item_Desc_Grandfathers_Ribs"	"Witch Doctorin kantamat kylkiluut kuuluivat hänen isoisälleen, suurelle shamaanille, joka kykeni puhumaan väkevien henkien kanssa. Isoisä tarjoaa Witch Doctorille voimaa, ja saa vastineeksi tilaisuuden nähdä jälleen, kuinka veri virtaa."
"[english]DOTA_Item_Desc_Grandfathers_Ribs"	"Witch Doctor carries the ribs of his old grandfather, a shaman who held powerful magicks and spoke with influential spirits. Grandfather offers the Witch Doctor access to power in exchange for the opportunity to see blood spilled once more."
"DOTA_Item_Desc_Rattlebite"	"Myös henget pelkäävät käärmeitä."
"[english]DOTA_Item_Desc_Rattlebite"	"Spirits are afraid of snakes, too."
"DOTA_Item_Desc_Vile_Carnival_Hat"	"Kun elämä on halpaa, sielut ovat maksuvälineinä."
"[english]DOTA_Item_Desc_Vile_Carnival_Hat"	"When life is cheap, souls are currency."
"DOTA_Item_Desc_Shrunken_Head_Staff"	"Tässä sauvassa keikkuva pää kuuluu Witch Doctorin äidille. Niin kultainen poika."
"[english]DOTA_Item_Desc_Shrunken_Head_Staff"	"The head of Witch Doctor's mother hangs from this staff. Such a loving son."
"DOTA_Item_Desc_Wooden_Fetish_Mask"	"Sen kuuluisi näyttää hymyltä."
"[english]DOTA_Item_Desc_Wooden_Fetish_Mask"	"It's supposed to be smiling."
"DOTA_Item_Desc_Tribal_Totem_Mask"	"Kaikki Witch Doctorin orjuuttamat henget eivät ole hänen esivanhempiensa. Tämä toteemi pitää sisällään suolla rämpivän Yando-pedon vangitun sielun."
"[english]DOTA_Item_Desc_Tribal_Totem_Mask"	"Not all of the Witch Doctor's enslaved spirits are ancestors. This household totem contains the trapped soul of a swamp dwelling Yando beast."
"DOTA_Item_Desc_Demon_Skull_Staff"	"Witch Doctor on selvästi kallojen perään."
"[english]DOTA_Item_Desc_Demon_Skull_Staff"	"Witch Doctor clearly has a thing for skulls."
"DOTA_Item_Desc_Staff_of_the_Old_Doctor"	"Witch Doctorin noustua heimonsa suurmieheksi hän valmisti sauvansa edeltäjänsä jäännöksistä. Ehkäpä hän teki sen kunnianosoituksena, mutta useimmat pitivät sitä varoituksena."
"[english]DOTA_Item_Desc_Staff_of_the_Old_Doctor"	"When the Witch Doctor rose to his position of power over his tribe, he fashioned this staff from the remains of the old Doctor. Perhaps it was meant as an honor, but most saw it as a warning."
"DOTA_WearableType_mount"	"ratsu"
"[english]DOTA_WearableType_mount"	"Mount"
"DOTA_Item_Disruptors_Weapon"	"Disruptorin ase"
"[english]DOTA_Item_Disruptors_Weapon"	"Disruptor's Weapon"
"DOTA_Item_Disruptors_Bracers"	"Disruptorin rannesuojat"
"[english]DOTA_Item_Disruptors_Bracers"	"Disruptor's Bracers"
"DOTA_Item_Desc_Copy_of_Disruptors_Weapon"	"Tällä uudella esineellä ei ole kuvausta."
"[english]DOTA_Item_Desc_Copy_of_Disruptors_Weapon"	"This new item has no description."
"DOTA_Item_Disruptors_Hair"	"Disruptorin hiukset"
"[english]DOTA_Item_Disruptors_Hair"	"Disruptor's Hair"
"DOTA_Item_Desc_Copy_of_Disruptors_Bracers"	"Tällä uudella esineellä ei ole kuvausta."
"[english]DOTA_Item_Desc_Copy_of_Disruptors_Bracers"	"This new item has no description."
"DOTA_Item_Disruptors_Back"	"Disruptorin selkä"
"[english]DOTA_Item_Disruptors_Back"	"Disruptor's Back"
"DOTA_Item_Desc_Copy_of_Disruptors_Hair"	"Tällä uudella esineellä ei ole kuvausta."
"[english]DOTA_Item_Desc_Copy_of_Disruptors_Hair"	"This new item has no description."
"DOTA_Item_Desc_Copy_of_Disruptors_Back"	"Tällä uudella esineellä ei ole kuvausta."
"[english]DOTA_Item_Desc_Copy_of_Disruptors_Back"	"This new item has no description."
"DOTA_Item_Disruptors_Mount"	"Disruptorin ratsu"
"[english]DOTA_Item_Disruptors_Mount"	"Disruptor's Mount"
"DOTA_Item_Desc_Copy_of_Disruptors_Shoulder_Armor"	"Tällä uudella esineellä ei ole kuvausta."
"[english]DOTA_Item_Desc_Copy_of_Disruptors_Shoulder_Armor"	"This new item has no description."
"DOTA_Item_Unusual_Paint_Blue"	"Erikoinen maali: Sininen"
"[english]DOTA_Item_Unusual_Paint_Blue"	"Unusual Paint: Blue"
"DOTA_Item_Unusual_Paint_Green"	"Erikoinen maali: Vihreä"
"[english]DOTA_Item_Unusual_Paint_Green"	"Unusual Paint: Green"
"DOTA_Item_Unusual_Paint_Light_Green"	"Erikoinen maali: Vaaleanvihreä"
"[english]DOTA_Item_Unusual_Paint_Light_Green"	"Unusual Paint: Light Green"
"DOTA_Item_Unusual_Paint_Gold"	"Erikoinen maali: Kulta"
"[english]DOTA_Item_Unusual_Paint_Gold"	"Unusual Paint: Gold"
"DOTA_Item_Unusual_Paint_Orange"	"Erikoinen maali: Oranssi"
"[english]DOTA_Item_Unusual_Paint_Orange"	"Unusual Paint: Orange"
"DOTA_WearableType_Skirt"	"hame"
"[english]DOTA_WearableType_Skirt"	"Skirt"
"DOTA_WearableType_Twinblade"	"kaksoisterä"
"[english]DOTA_WearableType_Twinblade"	"Twinblade"
"DOTA_WearableType_Spear"	"keihäs"
"[english]DOTA_WearableType_Spear"	"Spear"
"DOTA_WearableType_Drum"	"rumpu"
"[english]DOTA_WearableType_Drum"	"Drum"
"DOTA_WearableType_Fish_Club"	"kalanuija"
"[english]DOTA_WearableType_Fish_Club"	"Fish Club"
"DOTA_Item_Skeleton_Kings_head"	"Skeleton Kingin pää"
"[english]DOTA_Item_Skeleton_Kings_head"	"Skeleton King's head"
"DOTA_Item_Skeleton_Kings_Weapon"	"Skeleton Kingin ase"
"[english]DOTA_Item_Skeleton_Kings_Weapon"	"Skeleton King's Weapon"
"DOTA_Item_Skeleton_Kings_Cape"	"Skeleton Kingin viitta"
"[english]DOTA_Item_Skeleton_Kings_Cape"	"Skeleton King's Cape"
"DOTA_Item_Desc_SlayerSword_of_Sir_Davion"	"Lohikäärmettä vastaan miekan terävyys merkitsee vähemmän kuin mielen terävyys."
"[english]DOTA_Item_Desc_SlayerSword_of_Sir_Davion"	"When facing a dragon the edge of one's blade means less than the sharpness of one's mind."
"DOTA_Item_Desc_Pauldron_of_Sir_Davion"	"Dragon Knightia suojaa haarniskan sijaan hänen uskonsa."
"[english]DOTA_Item_Desc_Pauldron_of_Sir_Davion"	"A dragon knight is protected not by armor, but his faith."
"DOTA_Item_Desc_Bracer_of_Sir_Davion"	"Lohikäärmeestä on mahdotonta saada voittoa, ellei ensin hallitse itseään."
"[english]DOTA_Item_Desc_Bracer_of_Sir_Davion"	"Achieving mastery against dragons is impossible without first achieving mastery of the self."
"DOTA_Item_Desc_Hardened_Hunters_Bracer"	"Monet uskovat, ettei palkkionmetsästäjä lainkaan ajattele uhrejaan. Tosiasiassa palkkionmetsästäjä ymmärtää täysin kohteensa tuskan ja pelon. Hän ei vain välitä vähääkään."
"[english]DOTA_Item_Desc_Hardened_Hunters_Bracer"	"One might think that the bounty hunter thinks nothing of his victim. On the contrary, the bounty hunter understands his target's pain and fear. He simply does not care."
"DOTA_Item_Desc_Hardened_Hunters_Armor"	"Palkkatapon arvoa ei määrää pelkkä palkkion suuruus, vaan myös kalmankankealta kohteelta viety saalis."
"[english]DOTA_Item_Desc_Hardened_Hunters_Armor"	"The value of a contract is measured not only in the bounty paid, but in the loot taken from the mark's cold corpse."
"DOTA_Item_Desc_Hardened_Hunters_Mask"	"Monet ryövärit pitävät nahkaista kaulasuojusta suojatakseen kurkkunsa niin sanottujen 'liittolaistensa' tikareilta."
"[english]DOTA_Item_Desc_Hardened_Hunters_Mask"	"It's not uncommon for bandits to wear leather gorgets to protect their throats from the knives of their 'allies.'"
"DOTA_Item_Desc_Manifold_Spear"	"Kolmiteräinen keihäs. Valo näyttää heijastavun siitä oudosti."
"[english]DOTA_Item_Desc_Manifold_Spear"	"A spear with three edges. It seems to reflect the light strangely."
"DOTA_Item_Desc_Kingslayer_Axe"	"Neljän mestarisepän takoma kirves, jonka jokainen terä on työstetty hyvin tarkasti."
"[english]DOTA_Item_Desc_Kingslayer_Axe"	"An axe crafted by four master smiths, each edge carefully wrought."
"DOTA_Item_Desc_Edgebearers_Helm"	"Kypärä, terävä kuin kirves."
"[english]DOTA_Item_Desc_Edgebearers_Helm"	"A helm as sharp as an axe."
"DOTA_Item_Desc_Hammer_of_the_Dingus"	"Nimetön ase, joka on kääritty Kaikkinäkevän kirjasta poimittuun pyhään kirjoitukseen."
"[english]DOTA_Item_Desc_Hammer_of_the_Dingus"	"A nameless weapon, wrapped in holy scripture taken from the Book of the All Seeing."
"DOTA_Item_Announcer_Storm_Spirit"	"Kuuluttaja: Storm Spirit"
"[english]DOTA_Item_Announcer_Storm_Spirit"	"Announcer: Storm Spirit"
"DOTA_Item_Desc_Announcer_Storm_Spirit"	"Tämä paketti korvaa oletuskuuluttajan Storm Spiritin teatraalisella touhotuksella."
"[english]DOTA_Item_Desc_Announcer_Storm_Spirit"	"This pack replaces the Default announcer with the boisterous theatrics of Storm Spirit."
"DOTA_Item_Announcer_Pirate_Capn"	"Kuuluttaja: Merirosvokapteeni"
"[english]DOTA_Item_Announcer_Pirate_Capn"	"Announcer: Pirate Captain"
"DOTA_WearableType_Crown"	"kruunu"
"[english]DOTA_WearableType_Crown"	"Crown"
"DOTA_WearableType_Backpack"	"reppu"
"[english]DOTA_WearableType_Backpack"	"Backpack"
"DOTA_WearableType_Knife"	"puukko"
"[english]DOTA_WearableType_Knife"	"Knife"
"DOTA_Item_Desc_Copy_of_Brewmasters_Staff"	"Tällä uudella esineellä ei ole kuvausta."
"[english]DOTA_Item_Desc_Copy_of_Brewmasters_Staff"	"This new item has no description."
"DOTA_Item_Desc_Copy_of_Brewmasters_Barrel"	"Tällä uudella esineellä ei ole kuvausta."
"[english]DOTA_Item_Desc_Copy_of_Brewmasters_Barrel"	"This new item has no description."
"DOTA_Item_Desc_Copy_of_Brewmasters_Backpack"	"Tällä uudella esineellä ei ole kuvausta."
"[english]DOTA_Item_Desc_Copy_of_Brewmasters_Backpack"	"This new item has no description."
"DOTA_Item_Rikis_Horns"	"Rikin sarvet"
"[english]DOTA_Item_Rikis_Horns"	"Riki's Horns"
"DOTA_Item_Rikis_Tail"	"Rikin häntä"
"[english]DOTA_Item_Rikis_Tail"	"Riki's Tail"
"DOTA_Item_Rikis_Gloves"	"Rikin hanskat"
"[english]DOTA_Item_Rikis_Gloves"	"Riki's Gloves"
"DOTA_Item_Pugnas_Shoulder"	"Pugnan olkapää"
"[english]DOTA_Item_Pugnas_Shoulder"	"Pugna's Shoulder"
"DOTA_Item_Desc_Grand_Blade_of_the_Demigod"	"Tämä kauhistuttava miekka kaatoi muinaisen valtakunnan, jonka nimeä ei muista enää kukaan. Sen sijaan itse miekka ei tunnu katoavan tai unohtuvan koskaan."
"[english]DOTA_Item_Desc_Grand_Blade_of_the_Demigod"	"The name of the ancient kingdom that fell to this terrible blade has long been forgotten to history.  The blade itself, however, seems impossible to lose track of. "
"DOTA_Item_Desc_Copy_of_Creepers_Cruel_Shuriken"	"'Auts!'"
"[english]DOTA_Item_Desc_Copy_of_Creepers_Cruel_Shuriken"	"'Ouch!'"
"DOTA_Item_Desc_Copy_of_BladedStaff_of_the_Reaper"	"Tällä uudella esineellä ei ole kuvausta."
"[english]DOTA_Item_Desc_Copy_of_BladedStaff_of_the_Reaper"	"This new item has no description."
"DOTA_Item_Desc_Copy_of_Makeshift_Sword_of_the_Reaper"	"Tällä uudella esineellä ei ole kuvausta."
"[english]DOTA_Item_Desc_Copy_of_Makeshift_Sword_of_the_Reaper"	"This new item has no description."
"DOTA_Item_Desc_Bloodmist_Helm"	"Tämä kypärä istuu tukevasti päässä, vankentaen niskaa."
"[english]DOTA_Item_Desc_Bloodmist_Helm"	"This helm sits heavily on the head to strengthen the neck below."
"DOTA_Item_Desc_Demon_Claive"	"Sven näytti hyvin nostalgiselta nähdessään tämän miekan, muttei kertonut syytä."
"[english]DOTA_Item_Desc_Demon_Claive"	"Sven seemed overcome with nostalgia at the sight of this sword, though he would not say why."
"DOTA_Item_Desc_Bracers_of_Profound_Perfection"	"Vaikka monet velhot ovat Invokerille kateellisia hänen käsittämättömien voimiensa vuoksi, toiset kadehtivat vain hänen vertaansa vailla olevaa tyylitajuaan."
"[english]DOTA_Item_Desc_Bracers_of_Profound_Perfection"	"While many wizards are jealous of the Invoker's unimaginable power, others are merely jealous of his peerless taste."
"DOTA_Bundle_Desc_Summer_2012"	"Sisältää 47 (valtavan kasan!) uusia esineitä:"
"[english]DOTA_Bundle_Desc_Summer_2012"	"Includes a massive pile of 47 new items:"
"DOTA_Item_Desc_Copy_of_Nyxs_Weapon"	"Tällä uudella esineellä ei ole kuvausta."
"[english]DOTA_Item_Desc_Copy_of_Nyxs_Weapon"	"This new item has no description."
"DOTA_Item_Desc_Copy_of_Nyxs_Armor"	"Tällä uudella esineellä ei ole kuvausta."
"[english]DOTA_Item_Desc_Copy_of_Nyxs_Armor"	"This new item has no description."
"DOTA_WearableType_Booby_Trap"	"ansa"
"[english]DOTA_WearableType_Booby_Trap"	"Booby Trap"
"DOTA_Item_Desc_Obsidian_Destroyers_head"	"Tällä uudella esineellä ei ole kuvausta."
"[english]DOTA_Item_Desc_Obsidian_Destroyers_head"	"This new item has no description."
"DOTA_Item_Rubicks_Staff"	"Rubickin sauva"
"[english]DOTA_Item_Rubicks_Staff"	"Rubick's Staff"
"DOTA_Item_Desc_Copy_of_Rubicks_Staff"	"Tällä uudella esineellä ei ole kuvausta."
"[english]DOTA_Item_Desc_Copy_of_Rubicks_Staff"	"This new item has no description."
"DOTA_Item_Desc_Copy_of_Rubicks_Cape"	"Tällä uudella esineellä ei ole kuvausta."
"[english]DOTA_Item_Desc_Copy_of_Rubicks_Cape"	"This new item has no description."
"DOTA_Item_Desc_Copy_of_Necrolytes_Sickle"	"Tällä uudella esineellä ei ole kuvausta."
"[english]DOTA_Item_Desc_Copy_of_Necrolytes_Sickle"	"This new item has no description."
"DOTA_Item_Desc_Copy_of_Necrolytes_Beard"	"Tällä uudella esineellä ei ole kuvausta."
"[english]DOTA_Item_Desc_Copy_of_Necrolytes_Beard"	"This new item has no description."
"DOTA_Item_Desc_Copy_of_Necrolytes_Headdress"	"Tällä uudella esineellä ei ole kuvausta."
"[english]DOTA_Item_Desc_Copy_of_Necrolytes_Headdress"	"This new item has no description."
"DOTA_Item_Desc_Copy_of_Chens_Staff"	"Tällä uudella esineellä ei ole kuvausta."
"[english]DOTA_Item_Desc_Copy_of_Chens_Staff"	"This new item has no description."
"DOTA_Item_Desc_Copy_of_Chens_Mount"	"Tällä uudella esineellä ei ole kuvausta."
"[english]DOTA_Item_Desc_Copy_of_Chens_Mount"	"This new item has no description."
"DOTA_Item_Desc_Copy_of_Chens_Helmet"	"Tällä uudella esineellä ei ole kuvausta."
"[english]DOTA_Item_Desc_Copy_of_Chens_Helmet"	"This new item has no description."
"DOTA_Item_Desc_Copy_of_Chens_Bracers"	"Tällä uudella esineellä ei ole kuvausta."
"[english]DOTA_Item_Desc_Copy_of_Chens_Bracers"	"This new item has no description."
"DOTA_Item_Desc_Copy_of_Chens_Shoulder_Armor"	"Tällä uudella esineellä ei ole kuvausta."
"[english]DOTA_Item_Desc_Copy_of_Chens_Shoulder_Armor"	"This new item has no description."
"DOTA_Item_Desc_Copy_of_Treants_Head"	"Tällä uudella esineellä ei ole kuvausta."
"[english]DOTA_Item_Desc_Copy_of_Treants_Head"	"This new item has no description."
"DOTA_Item_Desc_Copy_of_Treants_Foliage"	"Tällä uudella esineellä ei ole kuvausta."
"[english]DOTA_Item_Desc_Copy_of_Treants_Foliage"	"This new item has no description."
"DOTA_Item_Desc_Copy_of_Treants_Hands"	"Tällä uudella esineellä ei ole kuvausta."
"[english]DOTA_Item_Desc_Copy_of_Treants_Hands"	"This new item has no description."
"DOTA_Item_Desc_Copy_of_Treants_Feet"	"Tällä uudella esineellä ei ole kuvausta."
"[english]DOTA_Item_Desc_Copy_of_Treants_Feet"	"This new item has no description."
"DOTA_Item_Desc_Copy_of_Dooms_Weapon"	"Tällä uudella esineellä ei ole kuvausta."
"[english]DOTA_Item_Desc_Copy_of_Dooms_Weapon"	"This new item has no description."
"DOTA_Item_Desc_Copy_of_Dooms_Helm"	"Tällä uudella esineellä ei ole kuvausta."
"[english]DOTA_Item_Desc_Copy_of_Dooms_Helm"	"This new item has no description."
"DOTA_Item_Desc_Copy_of_Dooms_Shoulder_Armor"	"Tällä uudella esineellä ei ole kuvausta."
"[english]DOTA_Item_Desc_Copy_of_Dooms_Shoulder_Armor"	"This new item has no description."
"DOTA_Item_Desc_Copy_of_Dooms_Bracers"	"Tällä uudella esineellä ei ole kuvausta."
"[english]DOTA_Item_Desc_Copy_of_Dooms_Bracers"	"This new item has no description."
"DOTA_Item_Desc_Copy_of_Dooms_Belt"	"Tällä uudella esineellä ei ole kuvausta."
"[english]DOTA_Item_Desc_Copy_of_Dooms_Belt"	"This new item has no description."
"DOTA_Item_Desc_Copy_of_Dooms_Wings"	"Tällä uudella esineellä ei ole kuvausta."
"[english]DOTA_Item_Desc_Copy_of_Dooms_Wings"	"This new item has no description."
"DOTA_Item_Desc_Copy_of_Shadow_Shamans_Weapon"	"Tällä uudella esineellä ei ole kuvausta."
"[english]DOTA_Item_Desc_Copy_of_Shadow_Shamans_Weapon"	"This new item has no description."
"DOTA_Item_Desc_Copy_of_Shadow_Shamans_Offhand_Weapon"	"Tällä uudella esineellä ei ole kuvausta."
"[english]DOTA_Item_Desc_Copy_of_Shadow_Shamans_Offhand_Weapon"	"This new item has no description."
"DOTA_Item_Desc_Copy_of_Shadow_Shamans_Headdress"	"Tällä uudella esineellä ei ole kuvausta."
"[english]DOTA_Item_Desc_Copy_of_Shadow_Shamans_Headdress"	"This new item has no description."
"DOTA_Item_Desc_Copy_of_Shadow_Shamans_Armor"	"Tällä uudella esineellä ei ole kuvausta."
"[english]DOTA_Item_Desc_Copy_of_Shadow_Shamans_Armor"	"This new item has no description."
"DOTA_Item_Desc_Copy_of_Shadow_Shamans_Stuff"	"Tällä uudella esineellä ei ole kuvausta."
"[english]DOTA_Item_Desc_Copy_of_Shadow_Shamans_Stuff"	"This new item has no description."
"DOTA_WearableType_Blade"	"terä"
"[english]DOTA_WearableType_Blade"	"Blade"
"DOTA_WearableType_Book"	"kirja"
"[english]DOTA_WearableType_Book"	"Book"
"DOTA_WearableType_Cask"	"tynnyri"
"[english]DOTA_WearableType_Cask"	"Cask"
"DOTA_WearableType_Flail"	"ketjukuulanuija"
"[english]DOTA_WearableType_Flail"	"Flail"
"DOTA_WearableType_Sickle"	"sirppi"
"[english]DOTA_WearableType_Sickle"	"Sickle"
"DOTA_WearableType_Bottle"	"pullo"
"[english]DOTA_WearableType_Bottle"	"Bottle"
"DOTA_WearableType_Belly_Guard"	"vatsapanssari"
"[english]DOTA_WearableType_Belly_Guard"	"Belly Guard"
"DOTA_WearableType_Club"	"nuija"
"[english]DOTA_WearableType_Club"	"Club"
"DOTA_WearableType_Cloak"	"viitta"
"[english]DOTA_WearableType_Cloak"	"Cloak"
"DOTA_WearableType_International_Courier"	"International-kuriiri"
"[english]DOTA_WearableType_International_Courier"	"International Courier"
"DOTA_WearableType_Fan"	"fanituote"
"[english]DOTA_WearableType_Fan"	"Fan Item"
"DOTA_Item_Blood_Seekers_Blade"	"Bloodseekerin terä"
"[english]DOTA_Item_Blood_Seekers_Blade"	"Blood Seeker's Blade"
"DOTA_Item_Blood_Seekers_Blade__OffHand"	"Bloodseekerin tukikäden terä"
"[english]DOTA_Item_Blood_Seekers_Blade__OffHand"	"Blood Seeker's Blade - Off-Hand"
"DOTA_Item_Blood_Seekers_Skirt"	"Bloodseekerin helma"
"[english]DOTA_Item_Blood_Seekers_Skirt"	"Blood Seeker's Skirt"
"DOTA_Item_Desc_Cerebral_Support"	"Mikä muinainen peto mahtoi kerran kantaa tätä? Tidehunter ei välitä."
"[english]DOTA_Item_Desc_Cerebral_Support"	"What ancient beast once wore this?  The Tidehunter cares not."
"DOTA_Item_Back_Hook__OffHand"	"Back Hook - Toisen käden"
"[english]DOTA_Item_Back_Hook__OffHand"	"Back Hook - Off-Hand"
"DOTA_Item_Desc_Horseshoe_Crab"	"Toisinaan Tidehunter kaipaa jotain hieman rapeampaa."
"[english]DOTA_Item_Desc_Horseshoe_Crab"	"Sometimes Tidehunter wants something a little more crunchy."
"DOTA_Item_Desc_Echinoderm_Shield"	"Mitä Tidehunter päättääkin pitää lemmikkinään, on hänen oma asiansa."
"[english]DOTA_Item_Desc_Echinoderm_Shield"	"What Tidehunter chooses to keep as a pet is his business."
"DOTA_Item_Desc_Tortoise_Paddle"	"Tidehunter ei juurikaan kehuskele keksinnöillään muille. Hän mieluummin hakkaa muita niillä."
"[english]DOTA_Item_Desc_Tortoise_Paddle"	"Tidehunter has never been one to brag about his inventions.  He only hits people with them."
"DOTA_Item_Bloodletter__OffHand"	"Bloodletter - Off-Hand"
"[english]DOTA_Item_Bloodletter__OffHand"	"Bloodletter - Off-Hand"
"DOTA_Item_Bonehunter_Slicer__OffHand"	"Bonehunter Slicer - Off-Hand"
"[english]DOTA_Item_Bonehunter_Slicer__OffHand"	"Bonehunter Slicer - Off-Hand"
"DOTA_Item_Desc_Carved_Grin_of_the_Trickster"	"Mutta hymyileekö Yurnero koskaan maskinsa takana?"
"[english]DOTA_Item_Desc_Carved_Grin_of_the_Trickster"	"But does Yurnero ever smile beneath the mask?"
"DOTA_Item_Desc_Summoners_Tambourine"	"Henget vastaavat usein niille, jotka pitävät kovinta meteliä."
"[english]DOTA_Item_Desc_Summoners_Tambourine"	"The spirits often respond to those who make the most noise."
"DOTA_Item_Desc_Spine_Sword"	"Useimmat pitävät selkäänpuukotetuksi joutumista esteenä, mutta muutamille se antaa ajatuksen."
"[english]DOTA_Item_Desc_Spine_Sword"	"Most see being stabbed in the back as a hindrance, but for a few, it's an inspiration."
"DOTA_Item_Desc_Mask_of_the_ManySighted"	"Naamioiden saarella kuolemalla sanotaan olevan monta valvovaa silmää."
"[english]DOTA_Item_Desc_Mask_of_the_ManySighted"	"On the Isle of Masks, death is said to have many watchful eyes."
"DOTA_WearableType_Sea_Beast"	"meripeto"
"[english]DOTA_WearableType_Sea_Beast"	"Sea Beast"
"DOTA_Item_Drows_Headwear"	"Drowin päähine"
"[english]DOTA_Item_Drows_Headwear"	"Drow's Headwear"
"DOTA_Item_Desc_Ice_Burst_Cloak"	"Tuikkivan huurteen viitta."
"[english]DOTA_Item_Desc_Ice_Burst_Cloak"	"A cloak of scintillating frost."
"DOTA_WearableType_Dagger"	"tikari"
"[english]DOTA_WearableType_Dagger"	"Dagger"
"DOTA_WearableType_Neck"	"kaula"
"[english]DOTA_WearableType_Neck"	"neck"
"DOTA_WearableType_Crests"	"harjakkeet"
"[english]DOTA_WearableType_Crests"	"Crests"
"DOTA_WearableType_Claw"	"käsiterä"
"[english]DOTA_WearableType_Claw"	"Claw"
"DOTA_WearableType_TwoHanded_Mace"	"kahden käden nuija"
"[english]DOTA_WearableType_TwoHanded_Mace"	"Two-Handed Mace"
"DOTA_WearableType_Lance"	"peitsi"
"[english]DOTA_WearableType_Lance"	"Lance"
"DOTA_WearableType_Halberd"	"hilpari"
"[english]DOTA_WearableType_Halberd"	"Halberd"
"DOTA_WearableType_Poleaxe"	"hilpari"
"[english]DOTA_WearableType_Poleaxe"	"Poleaxe"
"DOTA_WearableType_Egg"	"muna"
"[english]DOTA_WearableType_Egg"	"Egg"
"DOTA_WearableType_Paired_Weapons"	"asepari"
"[english]DOTA_WearableType_Paired_Weapons"	"Paired Weapons"
"DOTA_Item_Desc_Copy_of_Naga_Sirens_Sword"	"Tällä uudella esineellä ei ole kuvausta."
"[english]DOTA_Item_Desc_Copy_of_Naga_Sirens_Sword"	"This new item has no description."
"DOTA_Item_Sparrowhawk_Quiver"	"Sparrowhawk Quiver"
"[english]DOTA_Item_Sparrowhawk_Quiver"	"Sparrowhawk Quiver"
"DOTA_Item_Hammer_of_Light_Inexorable"	"Hammer of Light Inexorable"
"[english]DOTA_Item_Hammer_of_Light_Inexorable"	"Hammer of Light Inexorable"
"DOTA_Item_Desc_Hammer_of_Light_Inexorable"	"Tämä kummallinen leka, johon on riipustettu riimuja varmistaa, että kaikki vihollisesi näkevät valon."
"[english]DOTA_Item_Desc_Hammer_of_Light_Inexorable"	"This strange, rune-scrawled hammer will ensure that all your enemies see the light."
"DOTA_Item_Desc_the_evildoer"	"Tällä uudella esineellä ei ole kuvausta."
"[english]DOTA_Item_Desc_the_evildoer"	"This new item has no description."
"DOTA_Item_Sylvan_Guards_Bow"	"Sylvan Guard's Bow"
"[english]DOTA_Item_Sylvan_Guards_Bow"	"Sylvan Guard's Bow"
"DOTA_Item_Sylvan_Guards_Cape"	"Sylvan Guard's Cape"
"[english]DOTA_Item_Sylvan_Guards_Cape"	"Sylvan Guard's Cape"
"DOTA_Item_Bones_of_the_Bludgeoned"	"Bones of the Bludgeoned"
"[english]DOTA_Item_Bones_of_the_Bludgeoned"	"Bones of the Bludgeoned"
"DOTA_Item_Sylvan_Guards_Hair"	"Sylvan Guard's Hair"
"[english]DOTA_Item_Sylvan_Guards_Hair"	"Sylvan Guard's Hair"
"DOTA_Item_Sylvan_Guards_Quiver"	"Sylvan Guard's Quiver"
"[english]DOTA_Item_Sylvan_Guards_Quiver"	"Sylvan Guard's Quiver"
"DOTA_Item_Sylvan_Guards_Cuffs"	"Sylvan Guard's Cuffs"
"[english]DOTA_Item_Sylvan_Guards_Cuffs"	"Sylvan Guard's Cuffs"
"DOTA_Item_Ember_Scepter"	"Ember Scepter"
"[english]DOTA_Item_Ember_Scepter"	"Ember Scepter"
"DOTA_Item_Sylvan_Guards_Dress_Armor"	"Sylvan Guard's Dress Armor"
"[english]DOTA_Item_Sylvan_Guards_Dress_Armor"	"Sylvan Guard's Dress Armor"
"DOTA_Item_The_Half_Measure"	"The Half Measure"
"[english]DOTA_Item_The_Half_Measure"	"The Half Measure"
"DOTA_Item_Orichalcum_Ancient_Axe"	"Orichalcum Ancient Axe"
"[english]DOTA_Item_Orichalcum_Ancient_Axe"	"Orichalcum Ancient Axe"
"DOTA_Item_Holy_Spear_of_Images"	"Holy Spear of Images"
"[english]DOTA_Item_Holy_Spear_of_Images"	"Holy Spear of Images"
"DOTA_Item_Sprout_Staff"	"Sprout Staff"
"[english]DOTA_Item_Sprout_Staff"	"Sprout Staff"
"DOTA_Item_Loners_Vanity"	"Loner's Vanity"
"[english]DOTA_Item_Loners_Vanity"	"Loner's Vanity"
"DOTA_Item_Hair_of_the_Dark_Magic"	"Hair of the Dark Magic"
"[english]DOTA_Item_Hair_of_the_Dark_Magic"	"Hair of the Dark Magic"
"DOTA_Item_The_Lure_of_the_Scythe"	"The Lure of the Scythe"
"[english]DOTA_Item_The_Lure_of_the_Scythe"	"The Lure of the Scythe"
"DOTA_Item_Announcer_Axe"	"Kuuluttaja: Axe"
"[english]DOTA_Item_Announcer_Axe"	"Announcer: Axe"
"DOTA_Item_Treasure_of_the_Rogue_Knight"	"Kulkuriritarin aarre"
"[english]DOTA_Item_Treasure_of_the_Rogue_Knight"	"Treasure of the Rogue Knight"
"DOTA_Item_Desc_Mysterious_Egg"	"Kova, suomuinen muna, joka tuntuu olevan elossa ja melkein valmis kuoriutumaan. Se janoaa Diretiden syvyyksissä kuohuvaa maagista energiaa. Kuoriutuva olento määräytyy sen perusteella, mitä taikaa ja missä määrin tämä muna syö."
"[english]DOTA_Item_Desc_Mysterious_Egg"	"A hard, scaled egg that seems to be alive and almost ready to hatch. It hungers for the magical energies contained in Diretide essences. What comes out will be determined by the type and amount of magic the egg consumes."
"DOTA_Item_Shards_of_Polymorphia_Set"	"Shards of Polymorphia Set"
"[english]DOTA_Item_Shards_of_Polymorphia_Set"	"Shards of Polymorphia Set"
"DOTA_Item_Bindings_of_Frost_Set"	"Bindings of Frost Set"
"[english]DOTA_Item_Bindings_of_Frost_Set"	"Bindings of Frost Set"
"DOTA_Item_Birots_Bindings_Set"	"Birot's Bindings Set"
"[english]DOTA_Item_Birots_Bindings_Set"	"Birot's Bindings Set"
"DOTA_Item_Shards_of_the_Falling_Comet_Set"	"Shards of the Falling Comet Set"
"[english]DOTA_Item_Shards_of_the_Falling_Comet_Set"	"Shards of the Falling Comet Set"
"DOTA_Item_The_Crimson_Cutthroat_Set"	"The Crimson Cut-throat Set"
"[english]DOTA_Item_The_Crimson_Cutthroat_Set"	"The Crimson Cut-throat Set"
"DOTA_Item_Bloodletters"	"Bloodletters Pack"
"[english]DOTA_Item_Bloodletters"	"Bloodletters Pack"
"DOTA_Set_Axe_Berserker"	"The Berserker's Blood"
"[english]DOTA_Set_Axe_Berserker"	"The Berserker's Blood"
"DOTA_Set_Axe_Blood_Mist"	"Blood Mist Armor"
"[english]DOTA_Set_Axe_Blood_Mist"	"Bloodmist Armor"
"DOTA_Set_Axe_Defiant"	"The Defiant Axe"
"[english]DOTA_Set_Axe_Defiant"	"The Defiant Axe"
"DOTA_Set_Axe_Demon_Blood"	"Forged in Demons' Blood"
"[english]DOTA_Set_Axe_Demon_Blood"	"Forged in Demons' Blood"
"DOTA_Set_Axe_Executioner"	"The Axecutioner"
"[english]DOTA_Set_Axe_Executioner"	"The Axecutioner"
"DOTA_Set_Axe_Forgemaster"	"The Forgemaster's Tools"
"[english]DOTA_Set_Axe_Forgemaster"	"The Forgemaster's Tools"
"DOTA_Set_Axe_Heavy_Steel"	"Heavy Steel Armor"
"[english]DOTA_Set_Axe_Heavy_Steel"	"Heavy Steel Armor"
"DOTA_Set_Armor_of_the_Saberhorn"	"Armor of the Saberhorn"
"[english]DOTA_Set_Armor_of_the_Saberhorn"	"Armor of the Saberhorn"
"DOTA_Set_Bloodseeker_Hlotl"	"Ritual Garb of the Seeker"
"[english]DOTA_Set_Bloodseeker_Hlotl"	"Ritual Garb of the Seeker"
"DOTA_Set_Bloodseeker_Bonehunter"	"The Bonehunter"
"[english]DOTA_Set_Bloodseeker_Bonehunter"	"The Bonehunter"
"DOTA_Set_Creepers_Cruelty"	"Creeper's Cruelty"
"[english]DOTA_Set_Creepers_Cruelty"	"Creeper's Cruelty"
"DOTA_Set_The_Crimson_Cutthroat"	"The Crimson Cut-throat"
"[english]DOTA_Set_The_Crimson_Cutthroat"	"The Crimson Cut-throat"
"DOTA_Set_Bounty_Hunter_Hardened"	"Hardened Hunter's Gear"
"[english]DOTA_Set_Bounty_Hunter_Hardened"	"The Hardened Hunter"
"DOTA_Set_Bounty_Hunter_Master_Assassin"	"The Master Assassin"
"[english]DOTA_Set_Bounty_Hunter_Master_Assassin"	"The Master Assassin"
"DOTA_Set_Bounty_Hunter_Pangolin"	"Trappings of the Pangolin Guild"
"[english]DOTA_Set_Bounty_Hunter_Pangolin"	"Trappings of the Pangolin Guild"
"DOTA_Set_Black_Blades_of_the_Qaldin_Assassin"	"Black Blades of the Qaldin Assassin"
"[english]DOTA_Set_Black_Blades_of_the_Qaldin_Assassin"	"Black Blades of the Qaldin Assassin"
"DOTA_Set_Clinkz_Vandal"	"Demonic Vandal's Garb"
"[english]DOTA_Set_Clinkz_Vandal"	"The Demonic Vandal"
"DOTA_Set_Enchanted_Plate_of_the_Crimson_Wyvern"	"Enchanted Plate of the Crimson Wyvern"
"[english]DOTA_Set_Enchanted_Plate_of_the_Crimson_Wyvern"	"Enchanted Plate of the Crimson Wyvern"
"DOTA_Set_Dragon_Knight_Davion"	"Armor of Sir Davion"
"[english]DOTA_Set_Dragon_Knight_Davion"	"Armor of Sir Davion"
"DOTA_Set_FireBlessed_Mail_of_the_Drake"	"Fire-Blessed Mail of the Drake"
"[english]DOTA_Set_FireBlessed_Mail_of_the_Drake"	"Fire-Blessed Mail of the Drake"
"DOTA_Set_Bones_of_the_Slain_Dragon"	"Bones of the Slain Dragon"
"[english]DOTA_Set_Bones_of_the_Slain_Dragon"	"Bones of the Slain Dragon"
"DOTA_Set_Uldoraks_Hide"	"Uldorak's Hide"
"[english]DOTA_Set_Uldoraks_Hide"	"Uldorak's Hide"
"DOTA_Set_Drow_Ranger_Frost_Spikes"	"Spikes of Frost"
"[english]DOTA_Set_Drow_Ranger_Frost_Spikes"	"Spikes of Frost"
"DOTA_Set_Sylvan_Guards_Finery"	"Sylvan Guard's Finery"
"[english]DOTA_Set_Sylvan_Guards_Finery"	"Sylvan Guard's Finery"
"DOTA_Set_Faceless_Chronite"	"Chronite Defense"
"[english]DOTA_Set_Faceless_Chronite"	"Chronite Defense"
"DOTA_Set_Faceless_Clas"	"The Dials of Claszureme"
"[english]DOTA_Set_Faceless_Clas"	"The Dials of Claszureme"
"DOTA_Set_Furion_Beast_Bole"	"Master of Beast and Bole"
"[english]DOTA_Set_Furion_Beast_Bole"	"Master of Beast and Bole"
"DOTA_Set_Furion_Forest_Lord"	"The Regal Forest Lord"
"[english]DOTA_Set_Furion_Forest_Lord"	"The Regal Forest Lord"
"DOTA_Set_Furion_Heartwood_Vanguard"	"Heartwood Vanguard"
"[english]DOTA_Set_Furion_Heartwood_Vanguard"	"Heartwood Vanguard"
"DOTA_Set_Furion_Peace_Bringer"	"Garments of the Peace-Bringer"
"[english]DOTA_Set_Furion_Peace_Bringer"	"Garments of the Peace-Bringer"
"DOTA_Set_Furion_Scion_Savage"	"Scion of the Savage"
"[english]DOTA_Set_Furion_Scion_Savage"	"Scion of the Savage"
"DOTA_Set_Invoker_Exort"	"The Fires of Exort"
"[english]DOTA_Set_Invoker_Exort"	"The Fires of Exort"
"DOTA_Set_Invoker_Magus_Magnus"	"The Magus Magnus Set"
"[english]DOTA_Set_Invoker_Magus_Magnus"	"The Magus Magnus"
"DOTA_Set_Juggernaut_Beasts_Men"	"Aspects of Beast and Man"
"[english]DOTA_Set_Juggernaut_Beasts_Men"	"Aspects of Beast and Man"
"DOTA_Set_Juggernaut_Boar_God"	"The Boar God's Honor"
"[english]DOTA_Set_Juggernaut_Boar_God"	"The Boar God's Honor"
"DOTA_Set_Juggernaut_Brave"	"The Dauntless"
"[english]DOTA_Set_Juggernaut_Brave"	"The Dauntless"
"DOTA_Set_Juggernaut_High_Plains"	"Traveler on the High Plains"
"[english]DOTA_Set_Juggernaut_High_Plains"	"Traveler on the High Plains"
"DOTA_Set_Of_Ebony_and_Ivory"	"Of Ebony and Ivory"
"[english]DOTA_Set_Of_Ebony_and_Ivory"	"Of Ebony and Ivory"
"DOTA_Set_Kunkka_Admirable_Admiral"	"The Admirable Admiral"
"[english]DOTA_Set_Kunkka_Admirable_Admiral"	"The Admirable Admiral"
"DOTA_Set_Birots_Bindings"	"Birot's Bindings"
"[english]DOTA_Set_Birots_Bindings"	"Birot's Bindings"
"DOTA_Set_Direstone_Bindings"	"Direstone Bindings"
"[english]DOTA_Set_Direstone_Bindings"	"Direstone Bindings"
"DOTA_Set_Shards_of_the_Falling_Comet"	"Shards of the Falling Comet"
"[english]DOTA_Set_Shards_of_the_Falling_Comet"	"Shards of the Falling Comet"
"DOTA_Set_Bindings_of_Frost"	"Bindings of Frost"
"[english]DOTA_Set_Bindings_of_Frost"	"Bindings of Frost"
"DOTA_Set_Shards_of_Polymorphia"	"Shards of Polymorphia"
"[english]DOTA_Set_Shards_of_Polymorphia"	"Shards of Polymorphia"
"DOTA_Set_Radiant_Crystal_Bindings"	"Radiant Crystal Bindings"
"[english]DOTA_Set_Radiant_Crystal_Bindings"	"Radiant Crystal Bindings"
"DOTA_Set_Omniknight_Crusader"	"The Radiance of the Crusade"
"[english]DOTA_Set_Omniknight_Crusader"	"The Radiance of the Crusade"
"DOTA_Set_The_Hierophants_Protection"	"The Hierophant's Protection"
"[english]DOTA_Set_The_Hierophants_Protection"	"The Hierophant's Protection"
"DOTA_Set_Omniknight_Purist_Champion"	"Armor of the Purist Champion"
"[english]DOTA_Set_Omniknight_Purist_Champion"	"Armor of the Purist Champion"
"DOTA_Set_Armor_of_Renewed_Faith"	"Armor of Renewed Faith"
"[english]DOTA_Set_Armor_of_Renewed_Faith"	"Armor of Renewed Faith"
"DOTA_Set_Thunderwraths_Calling"	"Thunderwrath's Calling"
"[english]DOTA_Set_Thunderwraths_Calling"	"Thunderwrath's Calling"
"DOTA_Set_Wings_of_the_Paladin"	"Wings of the Paladin"
"[english]DOTA_Set_Wings_of_the_Paladin"	"Wings of the Paladin"
"DOTA_Set_Honors_of_the_Golden_Mane"	"Honors of the Golden Mane"
"[english]DOTA_Set_Honors_of_the_Golden_Mane"	"Honors of the Golden Mane"
"DOTA_Set_Revered_Arms"	"Revered Arms"
"[english]DOTA_Set_Revered_Arms"	"Revered Arms"
"DOTA_Set_Sven_Flameguard"	"Sect Armor of the Flameguard"
"[english]DOTA_Set_Sven_Flameguard"	"The Flameguard's Armor"
"DOTA_Set_Sven_Freelancer"	"The Freelancer's Finery"
"[english]DOTA_Set_Sven_Freelancer"	"The Freelancer's Finery"
"DOTA_Set_Sven_Mono_Militis"	"Sect Armor of the Mono Militis"
"[english]DOTA_Set_Sven_Mono_Militis"	"Sect Armor of the Mono Militis"
"DOTA_Set_Sven_Swordmaster"	"Swordmaster of the Vigil"
"[english]DOTA_Set_Sven_Swordmaster"	"Swordmaster of the Vigil"
"DOTA_Set_Tidehunter_Pirate_Slayer"	"The Pirate's Booty"
"[english]DOTA_Set_Tidehunter_Pirate_Slayer"	"The Pirate's Booty"
"DOTA_Set_Tidehunter_Punisher"	"The Paleogeneous Punisher"
"[english]DOTA_Set_Tidehunter_Punisher"	"The Paleogeneous Punisher"
"DOTA_Set_Ursa_Alpine_Stalker"	"Garb of the Alpine Stalker"
"[english]DOTA_Set_Ursa_Alpine_Stalker"	"The Alpine Stalker"
"DOTA_Set_Ursa_Iron_Bear"	"The Iron Bear"
"[english]DOTA_Set_Ursa_Iron_Bear"	"The Iron Bear"
"DOTA_Set_Ursa_Ravager"	"The Ursine Ravager"
"[english]DOTA_Set_Ursa_Ravager"	"The Ursine Ravager"
"DOTA_Set_Ursa_Savage_Age"	"The Savage Age"
"[english]DOTA_Set_Ursa_Savage_Age"	"The Savage Age"
"DOTA_Set_Falconers_Design"	"Falconer's Design"
"[english]DOTA_Set_Falconers_Design"	"Falconer's Design"
"DOTA_Set_Redwood_Arms"	"Redwood Arms"
"[english]DOTA_Set_Redwood_Arms"	"Redwood Arms"
"DOTA_Set_Flight_of_the_Sparrowhawk"	"Flight of the Sparrowhawk"
"[english]DOTA_Set_Flight_of_the_Sparrowhawk"	"Flight of the Sparrowhawk"
"DOTA_Set_ZaruKina_Protectors_Garb"	"Zaru'Kina Protector's Garb"
"[english]DOTA_Set_ZaruKina_Protectors_Garb"	"Zaru'Kina Protector's Garb"
"DOTA_Set_Witchdoctor_Tale_Teller"	"The Traveling Tale-Teller"
"[english]DOTA_Set_Witchdoctor_Tale_Teller"	"The Traveling Tale-Teller"
"DOTA_Set_Wicked_Bad_Voodoo"	"Wicked Bad Voodoo"
"[english]DOTA_Set_Wicked_Bad_Voodoo"	"Wicked Bad Voodoo"
"DOTA_WearableType_Glaive"	"terä"
"[english]DOTA_WearableType_Glaive"	"Glaive"
"DOTA_Item_AntiMages_Glaive"	"Anti-Magen terä"
"[english]DOTA_Item_AntiMages_Glaive"	"Anti-Mage's Glaive"
"DOTA_Item_Desc_Copy_of_Nightstalkers_Wings"	"Tällä uudella esineellä ei ole kuvausta."
"[english]DOTA_Item_Desc_Copy_of_Nightstalkers_Wings"	"This new item has no description."
"DOTA_Item_Desc_Copy_of_Nightstalkers_Armor"	"Tällä uudella esineellä ei ole kuvausta."
"[english]DOTA_Item_Desc_Copy_of_Nightstalkers_Armor"	"This new item has no description."
"DOTA_WearableType_Dress"	"puku"
"[english]DOTA_WearableType_Dress"	"Dress"
"DOTA_WearableType_Collar"	"kaulus"
"[english]DOTA_WearableType_Collar"	"Collar"
"DOTA_Item_Desc_Dark_Seers_Spikes"	"Tällä uudella esineellä ei ole kuvausta."
"[english]DOTA_Item_Desc_Dark_Seers_Spikes"	"This new item has no description."
"DOTA_Item_Desc_Dark_Seers_Hat"	"Tällä uudella esineellä ei ole kuvausta."
"[english]DOTA_Item_Desc_Dark_Seers_Hat"	"This new item has no description."
"DOTA_Item_Desc_Copy_of_Dark_Seers_Hat"	"Tällä uudella esineellä ei ole kuvausta."
"[english]DOTA_Item_Desc_Copy_of_Dark_Seers_Hat"	"This new item has no description."
"DOTA_Item_Desc_Dark_Seers_Loin_Cloth"	"Tällä uudella esineellä ei ole kuvausta."
"[english]DOTA_Item_Desc_Dark_Seers_Loin_Cloth"	"This new item has no description."
"DOTA_Item_Desc_Copy_of_Dark_Seers_Loin_Cloth"	"Tällä uudella esineellä ei ole kuvausta."
"[english]DOTA_Item_Desc_Copy_of_Dark_Seers_Loin_Cloth"	"This new item has no description."
"DOTA_Item_Desc_Copy_of_Slarks_Weapon"	"Tällä uudella esineellä ei ole kuvausta."
"[english]DOTA_Item_Desc_Copy_of_Slarks_Weapon"	"This new item has no description."
"DOTA_Item_Desc_Copy_of_Slarks_Bracers"	"Tällä uudella esineellä ei ole kuvausta."
"[english]DOTA_Item_Desc_Copy_of_Slarks_Bracers"	"This new item has no description."
"DOTA_Item_Desc_Copy_of_Slarks_Shoulder_Armor"	"Tällä uudella esineellä ei ole kuvausta."
"[english]DOTA_Item_Desc_Copy_of_Slarks_Shoulder_Armor"	"This new item has no description."
"DOTA_Item_Desc_Slarks_Hood"	"Tällä uudella esineellä ei ole kuvausta."
"[english]DOTA_Item_Desc_Slarks_Hood"	"This new item has no description."
"DOTA_Item_Desc_Copy_of_Centaurs_Axe"	"Tällä uudella esineellä ei ole kuvausta."
"[english]DOTA_Item_Desc_Copy_of_Centaurs_Axe"	"This new item has no description."
"DOTA_Item_Desc_Copy_of_Centaurs_Pride"	"Tällä uudella esineellä ei ole kuvausta."
"[english]DOTA_Item_Desc_Copy_of_Centaurs_Pride"	"This new item has no description."
"DOTA_Item_Desc_Copy_of_Centaurs_Upper_Armor"	"Tällä uudella esineellä ei ole kuvausta."
"[english]DOTA_Item_Desc_Copy_of_Centaurs_Upper_Armor"	"This new item has no description."
"DOTA_Item_Desc_Copy_of_Centaurs_Belt_Buckle"	"Tällä uudella esineellä ei ole kuvausta."
"[english]DOTA_Item_Desc_Copy_of_Centaurs_Belt_Buckle"	"This new item has no description."
"DOTA_Item_Desc_Copy_of_Centaurs_Trophies"	"Tällä uudella esineellä ei ole kuvausta."
"[english]DOTA_Item_Desc_Copy_of_Centaurs_Trophies"	"This new item has no description."
"DOTA_Item_Desc_Copy_of_Centaurs_Bracers"	"Tällä uudella esineellä ei ole kuvausta."
"[english]DOTA_Item_Desc_Copy_of_Centaurs_Bracers"	"This new item has no description."
"DOTA_WearableType_Trident"	"atrain"
"[english]DOTA_WearableType_Trident"	"Trident"
"DOTA_WearableType_Scythe"	"viikate"
"[english]DOTA_WearableType_Scythe"	"Scythe"
"DOTA_WearableType_Comb"	"kampa"
"[english]DOTA_WearableType_Comb"	"Comb"
"DOTA_WearableType_Lantern"	"lyhty"
"[english]DOTA_WearableType_Lantern"	"Lantern"
"DOTA_Item_Desc_Lions_Default_Weapon"	"Tällä uudella esineellä ei ole kuvausta."
"[english]DOTA_Item_Desc_Lions_Default_Weapon"	"This new item has no description."
"DOTA_Item_Desc_Copy_of_Lions_Default_Weapon"	"Tällä uudella esineellä ei ole kuvausta."
"[english]DOTA_Item_Desc_Copy_of_Lions_Default_Weapon"	"This new item has no description."
"DOTA_Item_Desc_Copy_of_Lions_Default_cape"	"Tällä uudella esineellä ei ole kuvausta."
"[english]DOTA_Item_Desc_Copy_of_Lions_Default_cape"	"This new item has no description."
"DOTA_Item_Desc_Copy_of_Lions_Default_Hat"	"Tällä uudella esineellä ei ole kuvausta."
"[english]DOTA_Item_Desc_Copy_of_Lions_Default_Hat"	"This new item has no description."
"DOTA_Item_Desc_Copy_of_Lions_Default_Shoulders"	"Tällä uudella esineellä ei ole kuvausta."
"[english]DOTA_Item_Desc_Copy_of_Lions_Default_Shoulders"	"This new item has no description."
"DOTA_Item_Ghastly_Treasure_of_Diretide"	"Ghastly Treasure of Diretide"
"[english]DOTA_Item_Ghastly_Treasure_of_Diretide"	"Ghastly Treasure of Diretide"
"DOTA_Item_Desc_Treasure_Chest_Diretide_2013"	"Tämän arkun avaamiseen tarvitaan <font color='#9da1a9'>Diretide-aarreavain</font>. Voit ostaa sellaisen Dota 2 -kaupasta."
"[english]DOTA_Item_Desc_Treasure_Chest_Diretide_2013"	"You will need a <font color='#9da1a9'>Diretide Treasure Key</font> to open this chest. You can pick one up at the DOTA 2 Store."
"DOTA_Item_Treasure_Key_Diretide"	"Diretide-aarreavain"
"[english]DOTA_Item_Treasure_Key_Diretide"	"Diretide Treasure Key"
"DOTA_Item_Desc_Copy_of_Pucks_Wings"	"Tällä uudella esineellä ei ole kuvausta."
"[english]DOTA_Item_Desc_Copy_of_Pucks_Wings"	"This new item has no description."
"DOTA_Item_Desc_Copy_of_Pucks_Tail"	"Tällä uudella esineellä ei ole kuvausta."
"[english]DOTA_Item_Desc_Copy_of_Pucks_Tail"	"This new item has no description."
"DOTA_Item_Desc_base_off_hand_ranged_weapon"	"Tällä uudella esineellä ei ole kuvausta."
"[english]DOTA_Item_Desc_base_off_hand_ranged_weapon"	"This new item has no description."
"DOTA_WearableType_Courier_Wearable"	"kuriirin asuste"
"[english]DOTA_WearableType_Courier_Wearable"	"Courier Wearable"
"DOTA_WearableType_Costume"	"asu"
"[english]DOTA_WearableType_Costume"	"Costume"
"DOTA_WearableType_Courier_Effect"	"kuriirin tehoste"
"[english]DOTA_WearableType_Courier_Effect"	"Courier Effect"
"DOTA_Item_Announcer_Death_Prophet"	"Kuuluttaja: Death Prophet"
"[english]DOTA_Item_Announcer_Death_Prophet"	"Announcer: Death Prophet"
"DOTA_WearableType_Courier"	"kuriiri"
"[english]DOTA_WearableType_Courier"	"Courier"
"DOTA_Item_Desc_Copy_of_Medusas_Bow"	"Tällä uudella esineellä ei ole kuvausta."
"[english]DOTA_Item_Desc_Copy_of_Medusas_Bow"	"This new item has no description."
"DOTA_Item_Desc_Copy_of_Medusas_Veil"	"Tällä uudella esineellä ei ole kuvausta."
"[english]DOTA_Item_Desc_Copy_of_Medusas_Veil"	"This new item has no description."
"DOTA_Item_Desc_Copy_of_Medusas_Chest_Armor"	"Tällä uudella esineellä ei ole kuvausta."
"[english]DOTA_Item_Desc_Copy_of_Medusas_Chest_Armor"	"This new item has no description."
"DOTA_Item_Desc_Copy_of_Medusas_Bracers"	"Tällä uudella esineellä ei ole kuvausta."
"[english]DOTA_Item_Desc_Copy_of_Medusas_Bracers"	"This new item has no description."
"DOTA_Item_Desc_Copy_of_Shredder_Drivers_Hat"	"Tällä uudella esineellä ei ole kuvausta."
"[english]DOTA_Item_Desc_Copy_of_Shredder_Drivers_Hat"	"This new item has no description."
"DOTA_Item_Desc_Copy_of_Shredders_Claw"	"Tällä uudella esineellä ei ole kuvausta."
"[english]DOTA_Item_Desc_Copy_of_Shredders_Claw"	"This new item has no description."
"DOTA_Item_Desc_Copy_of_Shredders_Chainsaw"	"Tällä uudella esineellä ei ole kuvausta."
"[english]DOTA_Item_Desc_Copy_of_Shredders_Chainsaw"	"This new item has no description."
"DOTA_Item_Desc_Copy_of_Shredders_Shoulder_Armor"	"Tällä uudella esineellä ei ole kuvausta."
"[english]DOTA_Item_Desc_Copy_of_Shredders_Shoulder_Armor"	"This new item has no description."
"DOTA_Item_Desc_Copy_of_Undyings_Bracer"	"Tällä uudella esineellä ei ole kuvausta."
"[english]DOTA_Item_Desc_Copy_of_Undyings_Bracer"	"This new item has no description."
"DOTA_Item_Desc_Copy_of_Undyings_Helmet"	"Tällä uudella esineellä ei ole kuvausta."
"[english]DOTA_Item_Desc_Copy_of_Undyings_Helmet"	"This new item has no description."
"DOTA_Item_Desc_Copy_of_Undyings_Armor"	"Tällä uudella esineellä ei ole kuvausta."
"[english]DOTA_Item_Desc_Copy_of_Undyings_Armor"	"This new item has no description."
"DOTA_Item_Diretide"	"Diretide"
"[english]DOTA_Item_Diretide"	"Diretide"
"DOTA_Item_Desc_Diretide"	"Diretide 2012 mukana tullut skin"
"[english]DOTA_Item_Desc_Diretide"	"Skin included with Diretide 2012"
"DOTA_WearableType_Wand"	"taikasauva"
"[english]DOTA_WearableType_Wand"	"Wand"
"DOTA_WearableType_Vest"	"liivi"
"[english]DOTA_WearableType_Vest"	"Vest"
"DOTA_WearableType_Monocle"	"monokkeli"
"[english]DOTA_WearableType_Monocle"	"Monocle"
"DOTA_WearableType_Heavy_Blade"	"raskas terä"
"[english]DOTA_WearableType_Heavy_Blade"	"Heavy Blade"
"DOTA_WearableType_Wrap"	"kääre"
"[english]DOTA_WearableType_Wrap"	"Wrap"
"DOTA_WearableType_Rifle"	"kivääri"
"[english]DOTA_WearableType_Rifle"	"Rifle"
"DOTA_WearableType_Pants"	"Housut"
"[english]DOTA_WearableType_Pants"	"Pants"
"DOTA_WearableType_Hud_Skin"	"ulkoasu"
"[english]DOTA_WearableType_Hud_Skin"	"HUD Skin"
"DOTA_WearableType_Treasure"	"aarre"
"[english]DOTA_WearableType_Treasure"	"Treasure"
"DOTA_Item_Desc_Copy_of_Shadow_Demons_Cape"	"Tällä uudella esineellä ei ole kuvausta."
"[english]DOTA_Item_Desc_Copy_of_Shadow_Demons_Cape"	"This new item has no description."
"DOTA_Item_Desc_Copy_of_Shadow_Demons_Armor"	"Tällä uudella esineellä ei ole kuvausta."
"[english]DOTA_Item_Desc_Copy_of_Shadow_Demons_Armor"	"This new item has no description."
"DOTA_Item_Desc_Copy_of_Shadow_Demons_Belt"	"Tällä uudella esineellä ei ole kuvausta."
"[english]DOTA_Item_Desc_Copy_of_Shadow_Demons_Belt"	"This new item has no description."
"DOTA_Item_Desc_Sharpeyes_Momentoes"	"Sniper on erinomainen ampuja. Nyt hänellä on mitalit, jotka todistavat sen!"
"[english]DOTA_Item_Desc_Sharpeyes_Momentoes"	"Sniper is an expert marksman.  Now he has the medals to prove it!"
"DOTA_Item_75_Battle_Bonus_2_Hours"	"75% Taistelubonus (2 tuntia)"
"[english]DOTA_Item_75_Battle_Bonus_2_Hours"	"75% Battle Bonus (2 Hours)"
"DOTA_Item_100_Battle_Bonus_2_Hours"	"100% Taistelubonus (2 tuntia)"
"[english]DOTA_Item_100_Battle_Bonus_2_Hours"	"100% Battle Bonus (2 Hours)"
"DOTA_Item_200_Battle_Bonus_2_Hours"	"200% Taistelubonus (2 tuntia)"
"[english]DOTA_Item_200_Battle_Bonus_2_Hours"	"200% Battle Bonus (2 Hours)"
"DOTA_Item_Desc_Copy_of_Miranas_Bow"	"Tällä uudella esineellä ei ole kuvausta."
"[english]DOTA_Item_Desc_Copy_of_Miranas_Bow"	"This new item has no description."
"DOTA_Item_Desc_Copy_of_Miranas_Mount"	"Tällä uudella esineellä ei ole kuvausta."
"[english]DOTA_Item_Desc_Copy_of_Miranas_Mount"	"This new item has no description."
"DOTA_Item_Desc_Copy_of_Miranas_Headdress"	"Tällä uudella esineellä ei ole kuvausta."
"[english]DOTA_Item_Desc_Copy_of_Miranas_Headdress"	"This new item has no description."
"DOTA_Item_Desc_Copy_of_Miranas_Cape"	"Tällä uudella esineellä ei ole kuvausta."
"[english]DOTA_Item_Desc_Copy_of_Miranas_Cape"	"This new item has no description."
"DOTA_Item_Desc_Copy_of_Miranas_Shoulders"	"Tällä uudella esineellä ei ole kuvausta."
"[english]DOTA_Item_Desc_Copy_of_Miranas_Shoulders"	"This new item has no description."
"DOTA_Item_Desc_Copy_of_Miranas_Bracers"	"Tällä uudella esineellä ei ole kuvausta."
"[english]DOTA_Item_Desc_Copy_of_Miranas_Bracers"	"This new item has no description."
"DOTA_WearableType_Sleeves"	"Hihat"
"[english]DOTA_WearableType_Sleeves"	"Sleeves"
"DOTA_Item_Desc_Blessings_of_the_Solar_Divine"	"Aurinkojumalattaren seuraajat kertoivat Linan hiusten olevan ”valon koskettamat”, joten he lahjoittivat hänelle koruja heijastamaan auringon lämmittävää lempeä."
"[english]DOTA_Item_Desc_Blessings_of_the_Solar_Divine"	"The acolytes of the Solar Goddess said Lina's hair was \"touched by the light\", and so gifted her with trinkets made to reflect the warming love of the sun."
"DOTA_Item_Desc_Sleeves_of_the_Solar_Divine"	"Hänen harjoitellessaan tulen hallintaa Lina vaelsi itään opiskelemaan Aurinkojumalattaren seuraajien parissa."
"[english]DOTA_Item_Desc_Sleeves_of_the_Solar_Divine"	"During her training in the flame arts, Lina chose to travel east to study with the followers of the Solar Goddess."
"DOTA_Item_Desc_Flares_of_the_Solar_Divine"	"Itäisissä erämaissa sanotaan olevan erityisen kuuma. Tulee aina pukeutua sään mukaan."
"[english]DOTA_Item_Desc_Flares_of_the_Solar_Divine"	"The heat of the eastern wastes is said to be extraordinary.  One must dress appropriately."
"DOTA_Item_Desc_Arc_of_the_Solar_Divine"	"Sanotaan, että taivaallisen inspiraation hetkellä itse Aurinkojumalatar vieraili Linan luona siunatakseen hänet voimallaan, ja antaakseen hänelle tämän lahjan."
"[english]DOTA_Item_Desc_Arc_of_the_Solar_Divine"	"It is said that in a moment of divine inspiration the Solar Goddess herself visited Lina to bless her with power, and grant her this gift."
"DOTA_WearableType_Harpoon"	"harpuuna"
"[english]DOTA_WearableType_Harpoon"	"Harpoon"
"DOTA_WearableType_Bag"	"säkki"
"[english]DOTA_WearableType_Bag"	"Bag"
"DOTA_WearableType_Demon"	"demoni"
"[english]DOTA_WearableType_Demon"	"Demon"
"DOTA_WearableType_Wings"	"Siivet"
"[english]DOTA_WearableType_Wings"	"Wings"
"DOTA_WearableType_Turban"	"turbaani"
"[english]DOTA_WearableType_Turban"	"Turban"
"DOTA_Item_Desc_Copy_of_Snipers_Weapon"	"Tällä uudella esineellä ei ole kuvausta."
"[english]DOTA_Item_Desc_Copy_of_Snipers_Weapon"	"This new item has no description."
"DOTA_Item_Desc_Copy_of_Snipers_Cape"	"Tällä uudella esineellä ei ole kuvausta."
"[english]DOTA_Item_Desc_Copy_of_Snipers_Cape"	"This new item has no description."
"DOTA_Item_Desc_Copy_of_Snipers_Head_Gear"	"Tällä uudella esineellä ei ole kuvausta."
"[english]DOTA_Item_Desc_Copy_of_Snipers_Head_Gear"	"This new item has no description."
"DOTA_Item_Desc_Copy_of_Snipers_Shoulder_Armor"	"Tällä uudella esineellä ei ole kuvausta."
"[english]DOTA_Item_Desc_Copy_of_Snipers_Shoulder_Armor"	"This new item has no description."
"DOTA_Item_Desc_Copy_of_Enchantress_Necklace"	"Tällä uudella esineellä ei ole kuvausta."
"[english]DOTA_Item_Desc_Copy_of_Enchantress_Necklace"	"This new item has no description."
"DOTA_Item_Desc_Copy_of_Enchantress_Hair"	"Tällä uudella esineellä ei ole kuvausta."
"[english]DOTA_Item_Desc_Copy_of_Enchantress_Hair"	"This new item has no description."
"DOTA_Item_Desc_Copy_of_Enchantress_Dress"	"Tällä uudella esineellä ei ole kuvausta."
"[english]DOTA_Item_Desc_Copy_of_Enchantress_Dress"	"This new item has no description."
"DOTA_Item_Desc_Copy_of_Enchantress_Bracers"	"Tällä uudella esineellä ei ole kuvausta."
"[english]DOTA_Item_Desc_Copy_of_Enchantress_Bracers"	"This new item has no description."
"DOTA_Item_Desc_venomancers_mandibles"	"Tällä uudella esineellä ei ole kuvausta."
"[english]DOTA_Item_Desc_venomancers_mandibles"	"This new item has no description."
"DOTA_Item_Desc_Copy_of_venomancers_mandibles"	"Tällä uudella esineellä ei ole kuvausta."
"[english]DOTA_Item_Desc_Copy_of_venomancers_mandibles"	"This new item has no description."
"DOTA_Item_Desc_Venomancers_Limbs"	"Tällä uudella esineellä ei ole kuvausta."
"[english]DOTA_Item_Desc_Venomancers_Limbs"	"This new item has no description."
"DOTA_Item_Desc_Copy_of_Venomancers_Limbs"	"Tällä uudella esineellä ei ole kuvausta."
"[english]DOTA_Item_Desc_Copy_of_Venomancers_Limbs"	"This new item has no description."
"DOTA_Item_Desc_Copy_of_Venomancers_Tail"	"Tällä uudella esineellä ei ole kuvausta."
"[english]DOTA_Item_Desc_Copy_of_Venomancers_Tail"	"This new item has no description."
"DOTA_Item_Desc_Copy_of_Meepos_Weapon"	"Tällä uudella esineellä ei ole kuvausta."
"[english]DOTA_Item_Desc_Copy_of_Meepos_Weapon"	"This new item has no description."
"DOTA_Item_Desc_Copy_of_Meepos_Hood"	"Tällä uudella esineellä ei ole kuvausta."
"[english]DOTA_Item_Desc_Copy_of_Meepos_Hood"	"This new item has no description."
"DOTA_Item_Desc_Copy_of_Meepos_Backpack"	"Tällä uudella esineellä ei ole kuvausta."
"[english]DOTA_Item_Desc_Copy_of_Meepos_Backpack"	"This new item has no description."
"DOTA_Item_Desc_Copy_of_Meepos_Shoulderpads"	"Tällä uudella esineellä ei ole kuvausta."
"[english]DOTA_Item_Desc_Copy_of_Meepos_Shoulderpads"	"This new item has no description."
"DOTA_Item_Desc_Copy_of_Meepos_Bracers"	"Tällä uudella esineellä ei ole kuvausta."
"[english]DOTA_Item_Desc_Copy_of_Meepos_Bracers"	"This new item has no description."
"DOTA_Item_Diretide_HUD_Skin"	"Diretide HUD-skin"
"[english]DOTA_Item_Diretide_HUD_Skin"	"Diretide HUD Skin"
"DOTA_Item_Desc_Diretide_HUD_Skin"	"Vuorovetten ja lämpötilojen muuttuessa elämä syntyy maaperästä. Diretide on saapunut."
"[english]DOTA_Item_Desc_Diretide_HUD_Skin"	"As tide and temperature turn, life ebbs from the land.  The Diretide has arrived."
"DOTA_WearableType_Tiara"	"tiara"
"[english]DOTA_WearableType_Tiara"	"Tiara"
"DOTA_WearableType_Eye"	"silmä"
"[english]DOTA_WearableType_Eye"	"Eye"
"DOTA_WearableType_Demon_Arm"	"demonikäsi"
"[english]DOTA_WearableType_Demon_Arm"	"Demon Arm"
"DOTA_WearableType_Sword_and_Shield"	"Miekka ja kilpi"
"[english]DOTA_WearableType_Sword_and_Shield"	"Sword and Shield"
"DOTA_WearableType_Cleaver"	"lihakirves"
"[english]DOTA_WearableType_Cleaver"	"Cleaver"
"DOTA_WearableType_Claws"	"Kynnet"
"[english]DOTA_WearableType_Claws"	"Claws"
"DOTA_WearableType_Ticket"	"lippu"
"[english]DOTA_WearableType_Ticket"	"Ticket"
"DOTA_WearableType_Chains"	"Ketjut"
"[english]DOTA_WearableType_Chains"	"Chains"
"DOTA_WearableType_Horn"	"sarvi"
"[english]DOTA_WearableType_Horn"	"Horn"
"DOTA_WearableType_Shell"	"kuori"
"[english]DOTA_WearableType_Shell"	"Shell"
"DOTA_WearableType_Lab_Coat"	"labratakki"
"[english]DOTA_WearableType_Lab_Coat"	"Lab Coat"
"DOTA_WearableType_Goggles"	"Suojalasit"
"[english]DOTA_WearableType_Goggles"	"Goggles"
"DOTA_WearableType_Flask"	"pullo"
"[english]DOTA_WearableType_Flask"	"Flask"
"DOTA_WearableType_Bandana"	"huivi"
"[english]DOTA_WearableType_Bandana"	"Bandana"
"DOTA_WearableType_Pipe"	"piippu"
"[english]DOTA_WearableType_Pipe"	"Pipe"
"DOTA_WearableType_Utility_Belt"	"monitoimivyö"
"[english]DOTA_WearableType_Utility_Belt"	"Utility Belt"
"DOTA_WearableType_Coat"	"takki"
"[english]DOTA_WearableType_Coat"	"Coat"
"DOTA_WearableType_Bat"	"lepakko"
"[english]DOTA_WearableType_Bat"	"Bat"
"DOTA_WearableType_Carapace"	"Kitiinipanssari"
"[english]DOTA_WearableType_Carapace"	"Carapace"
"DOTA_WearableType_Vines"	"köynnös"
"[english]DOTA_WearableType_Vines"	"Vines"
"DOTA_Item_Desc_Deadwinter_Neck"	"Nousu korkeampaan asemaan vaati jään herralle soveliaan asun - Ethreain hankki edellisessä elämässään käyttämänsä riekaleisen kaapunsa takaisin ja täytti sen pimeällä, pakkasenpuremalla epäkuolleen auralla."
"[english]DOTA_Item_Desc_Deadwinter_Neck"	"His ascension to a new throne and reign of ice deserved fitting attire - Ethreain reclaimed his tattered cloak from the previous life and imbued it with a darkened frost-bound undead aura."
"DOTA_Item_Desc_Deadwinter_Belt"	"Tiettyjen taikojen hallinta vaatii veronsa. Kun Ethreain hioi taitojaan ja kasvatti voimiaan, hän sulki jalkansa jäähän ja keräsi sirpaleita suojakseen. Tämä vyö auttaa häntä tasapainottamaan sisäistä huurrettaan, jotta se ei nielisi häntä itseään."
"[english]DOTA_Item_Desc_Deadwinter_Belt"	"Mastery of certain magics come with a price. As Ethreain honed his skill and grew stronger he encased his legs in ice and gathered shards to shield him. His sash helps to balance the frost within so that it does not consume him."
"DOTA_WearableType_Transdimensional_Delivery_Boy"	"ulottuvuuksienvälinen juoksupoika"
"[english]DOTA_WearableType_Transdimensional_Delivery_Boy"	"Transdimensional Delivery Boy"
"DOTA_WearableType_Servant_of_Selemene"	"Selemenen palvelija"
"[english]DOTA_WearableType_Servant_of_Selemene"	"Servant of Selemene"
"DOTA_WearableType_Shoulder_Armor"	"olkapanssari"
"[english]DOTA_WearableType_Shoulder_Armor"	"Shoulder Armor"
"DOTA_WearableType_Noble_Beast"	"jalo elikko"
"[english]DOTA_WearableType_Noble_Beast"	"Noble Beast"
"DOTA_WearableType_Horse"	"hevonen"
"[english]DOTA_WearableType_Horse"	"Horse"
"DOTA_WearableType_EyePatch"	"silmälappu"
"[english]DOTA_WearableType_EyePatch"	"Eye-Patch"
"DOTA_WearableType_Gauntlets"	"Hansikkaat"
"[english]DOTA_WearableType_Gauntlets"	"Gauntlets"
"DOTA_Item_Desc_Copy_of_bristelback_weapon"	"Tällä uudella esineellä ei ole kuvausta."
"[english]DOTA_Item_Desc_Copy_of_bristelback_weapon"	"This new item has no description."
"DOTA_Item_Desc_Copy_of_bristelback_back"	"Tällä uudella esineellä ei ole kuvausta."
"[english]DOTA_Item_Desc_Copy_of_bristelback_back"	"This new item has no description."
"DOTA_Item_Desc_Copy_of_bristelback_bracer"	"Tällä uudella esineellä ei ole kuvausta."
"[english]DOTA_Item_Desc_Copy_of_bristelback_bracer"	"This new item has no description."
"DOTA_Item_Desc_Copy_of_bristelback_head"	"Tällä uudella esineellä ei ole kuvausta."
"[english]DOTA_Item_Desc_Copy_of_bristelback_head"	"This new item has no description."
"DOTA_WearableType_Wine_Jug"	"viinikannu"
"[english]DOTA_WearableType_Wine_Jug"	"Wine Jug"
"DOTA_WearableType_Heavy_Axe"	"raskas kirves"
"[english]DOTA_WearableType_Heavy_Axe"	"Heavy Axe"
"DOTA_WearableType_Traditional_Hakama"	"perinteinen hakama"
"[english]DOTA_WearableType_Traditional_Hakama"	"Traditional Hakama"
"DOTA_WearableType_Ice"	"jää"
"[english]DOTA_WearableType_Ice"	"Ice"
"DOTA_WearableType_Blade_Weapon"	"teräase"
"[english]DOTA_WearableType_Blade_Weapon"	"Blade Weapon"
"DOTA_WearableType_Shoulder_Pad"	"olkasuojus"
"[english]DOTA_WearableType_Shoulder_Pad"	"Shoulder Pad"
"DOTA_WearableType_Bladed_Tail"	"teroitettu häntä"
"[english]DOTA_WearableType_Bladed_Tail"	"Bladed Tail"
"DOTA_WearableType_Slithereen_Dagger"	"kärmestikari"
"[english]DOTA_WearableType_Slithereen_Dagger"	"Slithereen Dagger"
"DOTA_Item_Desc_Copy_of_Vengeful_Wings"	"Tällä uudella esineellä ei ole kuvausta."
"[english]DOTA_Item_Desc_Copy_of_Vengeful_Wings"	"This new item has no description."
"DOTA_Item_Desc_Copy_of_Vengeful_Skirt"	"Tällä uudella esineellä ei ole kuvausta."
"[english]DOTA_Item_Desc_Copy_of_Vengeful_Skirt"	"This new item has no description."
"DOTA_Item_Desc_Copy_of_Vengeful_Bracers"	"Tällä uudella esineellä ei ole kuvausta."
"[english]DOTA_Item_Desc_Copy_of_Vengeful_Bracers"	"This new item has no description."
"DOTA_Item_Desc_Copy_of_Vengeful_Shoulders"	"Tällä uudella esineellä ei ole kuvausta."
"[english]DOTA_Item_Desc_Copy_of_Vengeful_Shoulders"	"This new item has no description."
"DOTA_Item_Desc_Copy_of_Vengeful_Hair"	"Tällä uudella esineellä ei ole kuvausta."
"[english]DOTA_Item_Desc_Copy_of_Vengeful_Hair"	"This new item has no description."
"DOTA_Item_Desc_Copy_of_Vengeful_Weapon"	"Tällä uudella esineellä ei ole kuvausta."
"[english]DOTA_Item_Desc_Copy_of_Vengeful_Weapon"	"This new item has no description."
"DOTA_Item_Desc_Akakiryu_of_a_Thousand_Faces"	"Tämä legendaarisen lohikäärmeen mukaan nimetty miekka annettiin Juggernautille päivänä, jona hänestä tuli miekkamestari."
"[english]DOTA_Item_Desc_Akakiryu_of_a_Thousand_Faces"	"Named after a legendary dragon, this sword was given to the Juggernaut on the day he became a swordmaster."
"DOTA_Item_Desc_Hakama_of_a_Thousand_Faces"	"Naamioiden saaren perinteinen hakama. Yurneron edesmennyt miekkamestari antoi sen hänelle, kauan ennen hänen karkoitustaan."
"[english]DOTA_Item_Desc_Hakama_of_a_Thousand_Faces"	"A traditional hakama from Isle of Masks. It was given to Yurnero by his late swordmaster, long before his exile."
"DOTA_Item_Desc_Bindings_of_Eldritch_Ice"	"Ethreain upotettiin Mustaan altaaseen painavan vyön kanssa; painovoima ei kuitenkaan vaikuta kuolleista nousseen Lichin ruumiiseen. Nyt hän kantaa vyötä irvaillakseen. Sanotaan, että kaikki hänen edellisen sydämensä lämpö sykkii nyt vyön taskumatissa, Lichin kylmän katseen alla."
"[english]DOTA_Item_Desc_Bindings_of_Eldritch_Ice"	"They sank Ethreain into the Black Pool with a weighted belt; but gravity has no pull on the Lich in his resurrected form. He wears the belt now as a mockery. And they say that all the warmth of his former heart resides in that pulsing flask, where he can keep a cold eye on it."
"DOTA_Item_Desc_Glacier_of_Eldritch_Ice"	"Syvällä Mustan altaan syövereissä, hukutettu mutta sammumaton kylmä raivo Lichin sydämessä jäädytti häntä ympäröivän veden. Nämä pahuuden jääsirpaleet kantavat sisällään kaunaa, joka ei sula koskaan."
"[english]DOTA_Item_Desc_Glacier_of_Eldritch_Ice"	"Drowned but not dead, deep in the Black Pool, the cold hatred in Lich's heart froze the water around him. These ice-shards, formed of evil, hold a hatred that will never melt."
"DOTA_WearableType_Swords"	"Miekat"
"[english]DOTA_WearableType_Swords"	"Swords"
"DOTA_WearableType_Armored_Lab_Coat"	"panssaroitu labratakki"
"[english]DOTA_WearableType_Armored_Lab_Coat"	"Armored Lab Coat"
"DOTA_WearableType_Keys"	"Avaimet"
"[english]DOTA_WearableType_Keys"	"Keys"
"DOTA_WearableType_Vambraces"	"käsipanssari"
"[english]DOTA_WearableType_Vambraces"	"Vambraces"
"DOTA_WearableType_Buckle"	"solki"
"[english]DOTA_WearableType_Buckle"	"Buckle"
"DOTA_WearableType_Shawl"	"saali"
"[english]DOTA_WearableType_Shawl"	"Shawl"
"DOTA_WearableType_Face"	"kasvot"
"[english]DOTA_WearableType_Face"	"Face"
"DOTA_WearableType_Stinger"	"pistin"
"[english]DOTA_WearableType_Stinger"	"Stinger"
"DOTA_Item_International_2013_Ticket"	"International 2013 Ticket"
"[english]DOTA_Item_International_2013_Ticket"	"International 2013 Ticket"
"DOTA_Item_The_International_2013_Ticket"	"The International 2013 Ticket"
"[english]DOTA_Item_The_International_2013_Ticket"	"The International 2013 Ticket"
"DOTA_Item_Cruel_Diretide"	"Cruel Diretide"
"[english]DOTA_Item_Cruel_Diretide"	"Cruel Diretide"
"DOTA_WearableType_International_HUD_Skin"	"International-ulkoasu"
"[english]DOTA_WearableType_International_HUD_Skin"	"International HUD Skin"
"DOTA_WearableType_Tusks"	"Syöksyhampaat"
"[english]DOTA_WearableType_Tusks"	"Tusks"
"DOTA_WearableType_Basket"	"kori"
"[english]DOTA_WearableType_Basket"	"Basket"
"DOTA_WearableType_Fist"	"nyrkki"
"[english]DOTA_WearableType_Fist"	"Fist"
"DOTA_WearableType_Runesword"	"riimumiekka"
"[english]DOTA_WearableType_Runesword"	"Runesword"
"DOTA_WearableType_Eye_Patch"	"silmälappu"
"[english]DOTA_WearableType_Eye_Patch"	"Eye Patch"
"DOTA_WearableType_The_Brave_Little_Courier"	"urhea pikkukuriiri"
"[english]DOTA_WearableType_The_Brave_Little_Courier"	"The Brave Little Courier"
"DOTA_WearableType_Player_Card"	"Pelaajakortti"
"[english]DOTA_WearableType_Player_Card"	"Player Card"
"DOTA_Item_Desc_Copy_of_Lunas_Helmet"	"Tällä uudella esineellä ei ole kuvausta."
"[english]DOTA_Item_Desc_Copy_of_Lunas_Helmet"	"This new item has no description."
"DOTA_Item_Desc_Copy_of_Lunas_Mount"	"Tällä uudella esineellä ei ole kuvausta."
"[english]DOTA_Item_Desc_Copy_of_Lunas_Mount"	"This new item has no description."
"DOTA_Item_Desc_Copy_of_Lunas_Shield"	"Tällä uudella esineellä ei ole kuvausta."
"[english]DOTA_Item_Desc_Copy_of_Lunas_Shield"	"This new item has no description."
"DOTA_Item_Desc_Copy_of_Lunas_Weapon"	"Tällä uudella esineellä ei ole kuvausta."
"[english]DOTA_Item_Desc_Copy_of_Lunas_Weapon"	"This new item has no description."
"DOTA_WearableType_Blouse"	"pusero"
"[english]DOTA_WearableType_Blouse"	"Blouse"
"DOTA_WearableType_Mitre"	"hiippa"
"[english]DOTA_WearableType_Mitre"	"Mitre"
"DOTA_WearableType_Pendant"	"riipus"
"[english]DOTA_WearableType_Pendant"	"Pendant"
"DOTA_WearableType_Riding_Cat"	"ratsastettava kissa"
"[english]DOTA_WearableType_Riding_Cat"	"Riding Cat"
"DOTA_WearableType_Sleeve"	"hiha"
"[english]DOTA_WearableType_Sleeve"	"Sleeve"
"DOTA_Item_Desc_Copy_of_Abaddons_Cape"	"Tällä uudella esineellä ei ole kuvausta."
"[english]DOTA_Item_Desc_Copy_of_Abaddons_Cape"	"This new item has no description."
"DOTA_Item_Desc_Copy_of_Abaddons_Helmet"	"Tällä uudella esineellä ei ole kuvausta."
"[english]DOTA_Item_Desc_Copy_of_Abaddons_Helmet"	"This new item has no description."
"DOTA_Item_Desc_Copy_of_Abaddons_Shoulder_Armor"	"Tällä uudella esineellä ei ole kuvausta."
"[english]DOTA_Item_Desc_Copy_of_Abaddons_Shoulder_Armor"	"This new item has no description."
"DOTA_Item_Desc_Copy_of_Abaddons_Weapon"	"Tällä uudella esineellä ei ole kuvausta."
"[english]DOTA_Item_Desc_Copy_of_Abaddons_Weapon"	"This new item has no description."
"DOTA_Item_Svens_Sword"	"Svenin miekka"
"[english]DOTA_Item_Svens_Sword"	"Sven's Sword"
"DOTA_WearableType_Caparison"	"kuviointi"
"[english]DOTA_WearableType_Caparison"	"Caparison"
"DOTA_WearableType_Doomblade"	"Tuomionterä"
"[english]DOTA_WearableType_Doomblade"	"Doomblade"
"DOTA_WearableType_Headfin"	"pääevä"
"[english]DOTA_WearableType_Headfin"	"Headfin"
"DOTA_WearableType_Intestines"	"Sisäelimet"
"[english]DOTA_WearableType_Intestines"	"Intestines"
"DOTA_WearableType_Pennant"	"viiri"
"[english]DOTA_WearableType_Pennant"	"Pennant"
"DOTA_WearableType_Shirt"	"paita"
"[english]DOTA_WearableType_Shirt"	"Shirt"
"DOTA_WearableType_Shroud"	"käärinliina"
"[english]DOTA_WearableType_Shroud"	"Shroud"
"DOTA_WearableType_Topknot"	"tupsu"
"[english]DOTA_WearableType_Topknot"	"Topknot"
"DOTA_WearableType_Treasure_Key"	"aarrearkun avain"
"[english]DOTA_WearableType_Treasure_Key"	"Treasure Key"
"DOTA_WearableType_Brave_Little_Courier"	"urhea pikkukuriiri"
"[english]DOTA_WearableType_Brave_Little_Courier"	"Brave Little Courier"
"DOTA_WearableType_Sigil"	"sinetti"
"[english]DOTA_WearableType_Sigil"	"Sigil"
"DOTA_WearableType_Chitin"	"Kitiini"
"[english]DOTA_WearableType_Chitin"	"Chitin"
"DOTA_WearableType_Fan_Item"	"fanituote"
"[english]DOTA_WearableType_Fan_Item"	"Fan Item"
"DOTA_WearableType_Roots"	"Juuret"
"[english]DOTA_WearableType_Roots"	"Roots"
"DOTA_WearableType_Vambrace"	"käsipanssari"
"[english]DOTA_WearableType_Vambrace"	"Vambrace"
"DOTA_WearableType_Whip"	"piiska"
"[english]DOTA_WearableType_Whip"	"Whip"
"DOTA_WearableType_Wolf"	"susi"
"[english]DOTA_WearableType_Wolf"	"Wolf"
"DOTA_WearableType_iG_Courier"	"iG-kuriiri"
"[english]DOTA_WearableType_iG_Courier"	"iG Courier"
"DOTA_Item_Desc_Copy_of_Earthshakers_Bracers"	"Tällä uudella esineellä ei ole kuvausta."
"[english]DOTA_Item_Desc_Copy_of_Earthshakers_Bracers"	"This new item has no description."
"DOTA_Item_Desc_Copy_of_Earthshakers_Totem"	"Tällä uudella esineellä ei ole kuvausta."
"[english]DOTA_Item_Desc_Copy_of_Earthshakers_Totem"	"This new item has no description."
"DOTA_Item_Earthshakers_Belt"	"Earthshakerin vyö"
"[english]DOTA_Item_Earthshakers_Belt"	"Earthshaker's Belt"
"DOTA_Item_Earthshakers_Bracers"	"Earthshakerin rannesuoja"
"[english]DOTA_Item_Earthshakers_Bracers"	"Earthshaker's Bracers"
"DOTA_Item_Earthshakers_Totem"	"Earthshakerin toteemi"
"[english]DOTA_Item_Earthshakers_Totem"	"Earthshaker's Totem"
"DOTA_WearableType_Bandanna"	"huivi"
"[english]DOTA_WearableType_Bandanna"	"Bandanna"
"DOTA_WearableType_Breastplate"	"rintapanssari"
"[english]DOTA_WearableType_Breastplate"	"Breastplate"
"DOTA_WearableType_Cauldron"	"pata"
"[english]DOTA_WearableType_Cauldron"	"Cauldron"
"DOTA_WearableType_Cowl"	"kaapu"
"[english]DOTA_WearableType_Cowl"	"Cowl"
"DOTA_WearableType_Dorsal_Fin"	"selkäevä"
"[english]DOTA_WearableType_Dorsal_Fin"	"Dorsal Fin"
"DOTA_WearableType_Dye"	"väriaine"
"[english]DOTA_WearableType_Dye"	"Dye"
"DOTA_WearableType_Fish_Courier"	"kalakuriiri"
"[english]DOTA_WearableType_Fish_Courier"	"Fish Courier"
"DOTA_WearableType_Ghosts"	"Aaveet"
"[english]DOTA_WearableType_Ghosts"	"Ghosts"
"DOTA_WearableType_Lure"	"syötti"
"[english]DOTA_WearableType_Lure"	"Lure"
"DOTA_WearableType_Mandrill_Courier"	"Mandrill-kuriiri"
"[english]DOTA_WearableType_Mandrill_Courier"	"Mandrill Courier"
"DOTA_WearableType_Molotov"	"Molotov"
"[english]DOTA_WearableType_Molotov"	"Molotov"
"DOTA_Item_Desc_A_Bit_of_Boat"	"Eräs kapinoiva merimies Kunkan miehistöstä pääsi melkein rannalle asti tällä purrella. Tidehunter kantaa sitä muistutuksena siitä kauhistuttavasta päivästä, aavistamatta lainkaan kuinka syvästi Kunkka arvostaa viestiä, jonka se lähettää mahdollisille karkureille."
"[english]DOTA_Item_Desc_A_Bit_of_Boat"	"A mutinous member of Kunkka's crew nearly made it to shore in this fateful craft. Tidehunter wields it as a reminder of that dread day, little knowing that Kunkka heartily approves of the message it sends to would-be deserters."
"DOTA_Item_Desc_Blue_Stone_Shoulder_of_the_Voyager"	"Kunkka ei ole piraatti. Ne kivet nyt vain makasivat maassa ja olisivat taatusti menneet hukkaan jos hän ei olisi ottanut niitä. Teknisesti ottaen, ne voitaisiin kyllä laskea ryöstösaaliiksi."
"[english]DOTA_Item_Desc_Blue_Stone_Shoulder_of_the_Voyager"	"Kunkka is no pirate. Still, the stones were just lying there and would have gone to waste had he not seized them. Technically, that might well constitute plundering."
"DOTA_Item_Desc_Craniomancer"	"Pyöreä pää on kauhistus. Samoin pyöreä selkä. Dark Seer ylpeilee nyt koko universumin ihanteellisimmalla pääkopalla. Kun taistoon käydään älyllä ja mielellä, kaikkein terävin pää nousee usein voittajaksi."
"[english]DOTA_Item_Desc_Craniomancer"	"A round head is an abomination.  So too, a round back.  Dark Seer now sports the cranium most ideal in all the universe.  In a battle of wits and wills, the pointiest head will often prevaile."
"DOTA_WearableType_Beast"	"peto"
"[english]DOTA_WearableType_Beast"	"Beast"
"DOTA_WearableType_Brains"	"Aivot!"
"[english]DOTA_WearableType_Brains"	"Brains!"
"DOTA_WearableType_Cap"	"lätsä"
"[english]DOTA_WearableType_Cap"	"Cap"
"DOTA_WearableType_Cloth_Armor"	"kangaspanssari"
"[english]DOTA_WearableType_Cloth_Armor"	"Cloth Armor"
"DOTA_WearableType_Hair_Style"	"kampaus"
"[english]DOTA_WearableType_Hair_Style"	"Hair Style"
"DOTA_WearableType_Hull"	"runko"
"[english]DOTA_WearableType_Hull"	"Hull"
"DOTA_WearableType_Jacket"	"takki"
"[english]DOTA_WearableType_Jacket"	"Jacket"
"DOTA_WearableType_Leg_Armor"	"jalkapanssari"
"[english]DOTA_WearableType_Leg_Armor"	"Leg Armor"
"DOTA_WearableType_Pistol"	"pistooli"
"[english]DOTA_WearableType_Pistol"	"Pistol"
"DOTA_WearableType_Priceless_Treasure"	"mittaamattoman arvokas aarre"
"[english]DOTA_WearableType_Priceless_Treasure"	"Priceless Treasure"
"DOTA_WearableType_Prow"	"Keula"
"[english]DOTA_WearableType_Prow"	"Prow"
"DOTA_WearableType_Signature"	"nimikirjoitusriimu"
"[english]DOTA_WearableType_Signature"	"Autograph Rune"
"DOTA_WearableType_Summon"	"kutsuttu"
"[english]DOTA_WearableType_Summon"	"Summon"
"DOTA_WearableType_True_Form"	"todellinen muoto"
"[english]DOTA_WearableType_True_Form"	"True Form"
"DOTA_WearableType_Warhorse"	"sotahevonen"
"[english]DOTA_WearableType_Warhorse"	"Warhorse"
"DOTA_WearableType_Crystal_Blade"	"kristalliterä"
"[english]DOTA_WearableType_Crystal_Blade"	"Crystal Blade"
"DOTA_WearableType_Dorsal_Fins"	"Selkäevät"
"[english]DOTA_WearableType_Dorsal_Fins"	"Dorsal Fins"
"DOTA_WearableType_Headwear"	"Päähine"
"[english]DOTA_WearableType_Headwear"	"Headwear"
"DOTA_WearableType_Item_Set"	"esinesarja"
"[english]DOTA_WearableType_Item_Set"	"Item Set"
"DOTA_WearableType_Masks"	"Naamiot"
"[english]DOTA_WearableType_Masks"	"Masks"
"DOTA_WearableType_Shoulder_guards"	"olkapanssari"
"[english]DOTA_WearableType_Shoulder_guards"	"Shoulder guards."
"DOTA_Item_Desc_Stoneshard_Belt"	"Pohjattomasta louhoksesta kaivetut kivensirpaleet ympäröivät Earthshakerin lanteita."
"[english]DOTA_Item_Desc_Stoneshard_Belt"	"Shards of stone, gathered from a bottomless quarry, gird Earthshaker's loins."
"DOTA_Item_Desc_Stoneshard_Crown"	"Kun sula maaperä jäähtyi, sen tahto otti itselleen Kivisirukruunun muodon; mutta kruunajaiset pidettiin vasta Earthshakerin saavuttua."
"[english]DOTA_Item_Desc_Stoneshard_Crown"	"As the molten earth cooled, its will was manifested in the Stoneshard Crown; but there was no coronation until Earthshaker's arrival."
"DOTA_WearableType_Amulet"	"amuletti"
"[english]DOTA_WearableType_Amulet"	"Amulet"
"DOTA_WearableType_Glove"	"hanska"
"[english]DOTA_WearableType_Glove"	"Glove"
"DOTA_WearableType_Pack"	"reppu"
"[english]DOTA_WearableType_Pack"	"Pack"
"DOTA_WearableType_Shreds"	"rääsyt"
"[english]DOTA_WearableType_Shreds"	"Shreds"
"DOTA_WearableType_Totem"	"toteemi"
"[english]DOTA_WearableType_Totem"	"Totem"
"DOTA_Item_Desc_Copy_of_WETA_Placeholder_1"	"Tällä uudella esineellä ei ole kuvausta."
"[english]DOTA_Item_Desc_Copy_of_WETA_Placeholder_1"	"This new item has no description."
"DOTA_Item_Desc_Copy_of_WETA_Placeholder_2"	"Tällä uudella esineellä ei ole kuvausta."
"[english]DOTA_Item_Desc_Copy_of_WETA_Placeholder_2"	"This new item has no description."
"DOTA_Item_Desc_Copy_of_WETA_Placeholder_3"	"Tällä uudella esineellä ei ole kuvausta."
"[english]DOTA_Item_Desc_Copy_of_WETA_Placeholder_3"	"This new item has no description."
"DOTA_WearableType_Baekho_Courier"	"Baekho-kuriiri"
"[english]DOTA_WearableType_Baekho_Courier"	"Baekho Courier"
"DOTA_WearableType_Stein"	"tuoppi"
"[english]DOTA_WearableType_Stein"	"Stein"
"DOTA_WearableType_Tournament_Bundle"	"turnauspaketti"
"[english]DOTA_WearableType_Tournament_Bundle"	"Tournament Bundle"
"DOTA_Item_Desc_Golden_Treasures"	"Rikkaudet voitetaan taistelukentällä."
"[english]DOTA_Item_Desc_Golden_Treasures"	"Riches are won on the battlefield."
"DOTA_Item_Desc_Hare_Hunt_Cape"	"Yhtä kultainen viitta kuin syksyiset metsät joiden läpi hän jäljittää vapisevaa saalistaan."
"[english]DOTA_Item_Desc_Hare_Hunt_Cape"	"A cape as golden as the autumn woods through which he stalks his tremulous prey."
"DOTA_Item_Desc_Tremor"	"Sota ravistelee kaikkea perustuksia myöten."
"[english]DOTA_Item_Desc_Tremor"	"War rattles every foundation."
"DOTA_WearableType_Back_Shield"	"selkäkilpi"
"[english]DOTA_WearableType_Back_Shield"	"Back Shield"
"DOTA_WearableType_Cape_and_Collar"	"Viitta ja kaulus"
"[english]DOTA_WearableType_Cape_and_Collar"	"Cape and Collar"
"DOTA_WearableType_Sabre"	"sapeli"
"[english]DOTA_WearableType_Sabre"	"Sabre"
"DOTA_Item_Desc_Copy_of_SteelSeries_Malaysia_Cup__October"	"Tällä uudella esineellä ei ole kuvausta."
"[english]DOTA_Item_Desc_Copy_of_SteelSeries_Malaysia_Cup__October"	"This new item has no description."
"DOTA_WearableType_Leg_Protection"	"jalkasuojus"
"[english]DOTA_WearableType_Leg_Protection"	"Leg Protection"
"DOTA_WearableType_Kilt"	"kiltti"
"[english]DOTA_WearableType_Kilt"	"Kilt"
"DOTA_WearableType_Paudron"	"olkapanssari"
"[english]DOTA_WearableType_Paudron"	"Paudron"
"DOTA_WearableType_Sack"	"säkki"
"[english]DOTA_WearableType_Sack"	"Sack"
"DOTA_Item_Desc_Vestments_of_the_Exiled_Ronin"	"Kun yksi luotettava miekka ei riitä. Karkotetun on syytä olla aina valmiina."
"[english]DOTA_Item_Desc_Vestments_of_the_Exiled_Ronin"	"When one trusty sword is not enough. An exile must always be prepared."
"DOTA_Item_Desc_Copy_of_Ember_Spirits_Back_Item"	"Tällä uudella esineellä ei ole kuvausta."
"[english]DOTA_Item_Desc_Copy_of_Ember_Spirits_Back_Item"	"This new item has no description."
"DOTA_Item_Desc_Copy_of_Ember_Spirits_Belt_Item"	"Tällä uudella esineellä ei ole kuvausta."
"[english]DOTA_Item_Desc_Copy_of_Ember_Spirits_Belt_Item"	"This new item has no description."
"DOTA_Item_Desc_Copy_of_Ember_Spirits_Head_Item"	"Tällä uudella esineellä ei ole kuvausta."
"[english]DOTA_Item_Desc_Copy_of_Ember_Spirits_Head_Item"	"This new item has no description."
"DOTA_Item_Desc_Copy_of_Ember_Spirits_Main_Weapon"	"Tällä uudella esineellä ei ole kuvausta."
"[english]DOTA_Item_Desc_Copy_of_Ember_Spirits_Main_Weapon"	"This new item has no description."
"DOTA_Item_Desc_Copy_of_Ember_Spirits_Offhand_Weapon"	"Tällä uudella esineellä ei ole kuvausta."
"[english]DOTA_Item_Desc_Copy_of_Ember_Spirits_Offhand_Weapon"	"This new item has no description."
"DOTA_Item_Desc_Copy_of_Ember_Spirits_Shoulders"	"Tällä uudella esineellä ei ole kuvausta."
"[english]DOTA_Item_Desc_Copy_of_Ember_Spirits_Shoulders"	"This new item has no description."
"DOTA_Item_Desc_Diretide_2013_Treasure_Key"	"Tällä avataan <font color='#9da1a9'>Ghastly Treasure of Diretide </font>-arkkuja. Kaksoisnapsauta avainta repussasi tai napsauta sitä hiiren oikealla painikkeella ja valitse arkku, jonka tahdot avata."
"[english]DOTA_Item_Desc_Diretide_2013_Treasure_Key"	"Used to open locked <font color='#9da1a9'>Ghastly Treasure of Diretide </font> Chests. Double click or right-click the key in your backpack and select the chest you want to open."
"DOTA_Item_Desc_Mace_of_Lunacy_Bringer"	"Sauva tai ase. Hullussa maailmassa niillä ei ole pienintäkään eroa."
"[english]DOTA_Item_Desc_Mace_of_Lunacy_Bringer"	"Wand or weapon, such distinctions mean nothing in a mad realm."
"DOTA_Item_Desc_Recipe_Hollow_Jack"	"Tällä reseptillä yhdistät Ghastly Treasure of Diretidesta saaman esineen minkä tahansa kirotun esineen kanssa luodaksesi Hollow Jack -kuriirin."
"[english]DOTA_Item_Desc_Recipe_Hollow_Jack"	"This recipe will combine an item from the Ghastly Treasure of Diretide with any Cursed item to produce a Hollow Jack courier."
"DOTA_Item_Diretide_2013_Treasure_Key"	"Diretide 2013 -aarreavain"
"[english]DOTA_Item_Diretide_2013_Treasure_Key"	"Diretide 2013 Treasure Key"
}
}
