"lang"
{
"Language"	"japanese"
"Tokens"
{
"DOTA_WearableType_Daggers"	"短剣(Daggers)"
"[english]DOTA_WearableType_Daggers"	"Daggers"
"DOTA_WearableType_Glaives"	"グレイブ(Glaives)"
"[english]DOTA_WearableType_Glaives"	"Glaives"
"DOTA_WearableType_Weapon"	"武器"
"[english]DOTA_WearableType_Weapon"	"Mace"
"DOTA_WearableType_Armor"	"アーマー"
"[english]DOTA_WearableType_Armor"	"armor"
"DOTA_WearableType_Hair"	"髪型"
"[english]DOTA_WearableType_Hair"	"Hair"
"DOTA_WearableType_Belt"	"ベルト"
"[english]DOTA_WearableType_Belt"	"belt"
"DOTA_WearableType_Mask"	"マスク"
"[english]DOTA_WearableType_Mask"	"Mask"
"DOTA_WearableType_Cape"	"肩マント"
"[english]DOTA_WearableType_Cape"	"Cape"
"DOTA_WearableType_Bracer"	"籠手"
"[english]DOTA_WearableType_Bracer"	"Bracer"
"DOTA_WearableType_Boots"	"ブーツ"
"[english]DOTA_WearableType_Boots"	"Boots"
"DOTA_WearableType_Hands"	"手"
"[english]DOTA_WearableType_Hands"	"Hands"
"DOTA_WearableType_Head"	"頭部"
"[english]DOTA_WearableType_Head"	"head"
"DOTA_WearableType_Mace"	"職杖"
"[english]DOTA_WearableType_Mace"	"Mace"
"DOTA_WearableType_Gauntlet"	"篭手"
"[english]DOTA_WearableType_Gauntlet"	"Gauntlet"
"DOTA_WearableType_Shoulder"	"肩部"
"[english]DOTA_WearableType_Shoulder"	"shoulder"
"DOTA_WearableType_Bow"	"弓"
"[english]DOTA_WearableType_Bow"	"Bow"
"DOTA_WearableType_ShoulderPads"	"肩当て"
"[english]DOTA_WearableType_ShoulderPads"	"Shoulderpads"
"DOTA_WearableType_Quiver"	"矢筒"
"[english]DOTA_WearableType_Quiver"	"Quiver"
"DOTA_WearableType_Shield"	"シールド"
"[english]DOTA_WearableType_Shield"	"Shield"
"DOTA_WearableType_Horns"	"角製品"
"[english]DOTA_WearableType_Horns"	"Horns"
"DOTA_WearableType_Beard"	"ひげ"
"[english]DOTA_WearableType_Beard"	"Beard"
"DOTA_WearableType_Necklace"	"首飾り"
"[english]DOTA_WearableType_Necklace"	"Necklace"
"DOTA_WearableType_Fish_Treat"	"Fish Treat"
"[english]DOTA_WearableType_Fish_Treat"	"Fish Treat"
"DOTA_WearableType_Meathook"	"Meathook"
"[english]DOTA_WearableType_Meathook"	"Meathook"
"DOTA_WearableType_Offhand_weapon"	"逆腕使用の武器"
"[english]DOTA_WearableType_Offhand_weapon"	"Offhand Weapon"
"DOTA_WearableType_Back"	"背中"
"[english]DOTA_WearableType_Back"	"back"
"DOTA_WearableType_Gloves"	"手袋"
"[english]DOTA_WearableType_Gloves"	"Gloves"
"DOTA_WearableType_Legs"	"脚"
"[english]DOTA_WearableType_Legs"	"Legs"
"DOTA_WearableType_offhand"	"逆腕"
"[english]DOTA_WearableType_offhand"	"offhand"
"DOTA_WearableType_arms"	"腕"
"[english]DOTA_WearableType_arms"	"Arms"
"DOTA_WearableType_Unnamed_New_Item"	"新アイテム"
"[english]DOTA_WearableType_Unnamed_New_Item"	"New Item"
"DOTA_WearableType_New_Item"	"新アイテム"
"[english]DOTA_WearableType_New_Item"	"New Item"
"DOTA_WearableType_body"	"胴部"
"[english]DOTA_WearableType_body"	"Body"
"DOTA_WearableType_Tail"	"尻尾"
"[english]DOTA_WearableType_Tail"	"Tail"
"DOTA_WearableType_Pauldrons"	"肩甲"
"[english]DOTA_WearableType_Pauldrons"	"Pauldrons"
"DOTA_WearableType_Chain_Weapon"	"鎖武器"
"[english]DOTA_WearableType_Chain_Weapon"	"Chain Weapon"
"DOTA_WearableType_Helm"	"兜(Helm)"
"[english]DOTA_WearableType_Helm"	"Helm"
"DOTA_WearableType_Pegleg"	"Makeshift Prosthetic"
"[english]DOTA_WearableType_Pegleg"	"Makeshift Prosthetic"
"DOTA_WearableType_Sword"	"剣"
"[english]DOTA_WearableType_Sword"	"Sword"
"DOTA_WearableType_Hat"	"帽子"
"[english]DOTA_WearableType_Hat"	"Hat"
"DOTA_WearableType_Ability_Modifier"	"アビリティモディファイア"
"[english]DOTA_WearableType_Ability_Modifier"	"Ability Modifier"
"DOTA_WearableType_Toga"	"職服"
"[english]DOTA_WearableType_Toga"	"Toga"
"DOTA_WearableType_Hand"	"手"
"[english]DOTA_WearableType_Hand"	"Hand"
"DOTA_WearableType_Taunt"	"挑発"
"[english]DOTA_WearableType_Taunt"	"Taunt"
"DOTA_WearableType_Skin"	"スキン"
"[english]DOTA_WearableType_Skin"	"Skin"
"DOTA_WearableType_Alternate_Ultimate"	"代替アルティメット"
"[english]DOTA_WearableType_Alternate_Ultimate"	"Alternate Ultimate"
"DOTA_WearableType_Alternate_Attack"	"代替攻撃"
"[english]DOTA_WearableType_Alternate_Attack"	"Alternate Attack"
"DOTA_WearableType_Pauldron"	"肩甲"
"[english]DOTA_WearableType_Pauldron"	"Pauldron"
"DOTA_WearableType_Spaulder"	"肩当て"
"[english]DOTA_WearableType_Spaulder"	"Spaulder"
"DOTA_WearableType_Squishy_Hat"	"やわらかい帽子"
"[english]DOTA_WearableType_Squishy_Hat"	"Squishy Hat"
"DOTA_WearableType_Bracers"	"籠手"
"[english]DOTA_WearableType_Bracers"	"Bracers"
"DOTA_WearableType_Robe"	"ローブ"
"[english]DOTA_WearableType_Robe"	"Robe"
"DOTA_WearableType_Headdress"	"頭飾り"
"[english]DOTA_WearableType_Headdress"	"Headdress"
"DOTA_WearableType_Mailed_Skirt"	"かたびらのスカート"
"[english]DOTA_WearableType_Mailed_Skirt"	"Mailed Skirt"
"DOTA_WearableType_Hat_and_Hair"	"帽子と髪型"
"[english]DOTA_WearableType_Hat_and_Hair"	"Hat and Hair"
"DOTA_WearableType_Shoes"	"靴"
"[english]DOTA_WearableType_Shoes"	"Shoes"
"DOTA_WearableType_Spikes"	"スパイク"
"[english]DOTA_WearableType_Spikes"	"Spikes"
"DOTA_WearableType_Bone_Helm"	"骨のヘルメット"
"[english]DOTA_WearableType_Bone_Helm"	"Bone Helm"
"DOTA_WearableType_Fins"	"ヒレ"
"[english]DOTA_WearableType_Fins"	"Fins"
"DOTA_WearableType_Axe"	"斧"
"[english]DOTA_WearableType_Axe"	"Axe"
"DOTA_WearableType_Shoulder_Guard"	"肩防具"
"[english]DOTA_WearableType_Shoulder_Guard"	"Shoulder Guard"
"DOTA_WearableType_Cloak_and_Tunic"	"外套とチュニック"
"[english]DOTA_WearableType_Cloak_and_Tunic"	"Cloak and Tunic"
"DOTA_WearableType_Hammer"	"ハンマー"
"[english]DOTA_WearableType_Hammer"	"Hammer"
"DOTA_WearableType_Dead_Shark"	"死んだサメ"
"[english]DOTA_WearableType_Dead_Shark"	"Dead Shark"
"DOTA_WearableType_Finished_Lunch"	"食べ終わった昼食"
"[english]DOTA_WearableType_Finished_Lunch"	"Finished Lunch"
"DOTA_WearableType_Bone_Club"	"骨の棍棒"
"[english]DOTA_WearableType_Bone_Club"	"Bone Club"
"DOTA_WearableType_Makeshift_Weapon"	"間に合わせの武器"
"[english]DOTA_WearableType_Makeshift_Weapon"	"Makeshift Weapon"
"DOTA_WearableType_Shoulderguard"	"肩防具"
"[english]DOTA_WearableType_Shoulderguard"	"Shoulderguard"
"DOTA_WearableType_Fancy_Pantaloons"	"お洒落なズボン"
"[english]DOTA_WearableType_Fancy_Pantaloons"	"Fancy Pantaloons"
"DOTA_WearableType_Cloth_Bracer"	"布の籠手"
"[english]DOTA_WearableType_Cloth_Bracer"	"Cloth Bracer"
"DOTA_WearableType_Stuffed_Toy"	"ぬいぐるみのおもちゃ"
"[english]DOTA_WearableType_Stuffed_Toy"	"Stuffed Toy"
"DOTA_WearableType_Staff"	"杖"
"[english]DOTA_WearableType_Staff"	"Staff"
"DOTA_WearableType_Gruesome_Trophies"	"不気味なトロフィー"
"[english]DOTA_WearableType_Gruesome_Trophies"	"Gruesome Trophies"
"DOTA_WearableType_Hood"	"頭巾"
"[english]DOTA_WearableType_Hood"	"Hood"
"DOTA_WearableType_Shuriken"	"手裏剣"
"[english]DOTA_WearableType_Shuriken"	"Shuriken"
"DOTA_WearableType_Mancatcher"	"人捕り"
"[english]DOTA_WearableType_Mancatcher"	"Mancatcher"
"DOTA_WearableType_Apron"	"前掛け"
"[english]DOTA_WearableType_Apron"	"Apron"
"DOTA_WearableType_Armlet"	"腕飾り"
"[english]DOTA_WearableType_Armlet"	"Armlet"
"DOTA_WearableType_Scepter"	"杖（Scepter）"
"[english]DOTA_WearableType_Scepter"	"Scepter"
"DOTA_WearableType_Greaves"	"すね当て"
"[english]DOTA_WearableType_Greaves"	"Greaves"
"DOTA_WearableType_Saw"	"のこぎり"
"[english]DOTA_WearableType_Saw"	"Saw"
"DOTA_WearableType_Hook"	"鉤爪"
"[english]DOTA_WearableType_Hook"	"Hook"
"DOTA_WearableType_Abdomen"	"腹部"
"[english]DOTA_WearableType_Abdomen"	"Abdomen"
"DOTA_WearableType_Flag"	"旗"
"[english]DOTA_WearableType_Flag"	"Flag"
"DOTA_WearableType_Blade_RightHand"	"刀、右手"
"[english]DOTA_WearableType_Blade_RightHand"	"Blade, Right-Hand"
"DOTA_WearableType_Blade_LeftHand"	"刀、左手"
"[english]DOTA_WearableType_Blade_LeftHand"	"Blade, Left-Hand"
"DOTA_WearableType_Scarf"	"スカーフ"
"[english]DOTA_WearableType_Scarf"	"Scarf"
"DOTA_WearableType_Leather_Pants"	"革のズボン"
"[english]DOTA_WearableType_Leather_Pants"	"Leather Pants"
"DOTA_WearableType_Blade_RightHanded"	"刀、右手"
"[english]DOTA_WearableType_Blade_RightHanded"	"Blade, Right-Handed"
"DOTA_WearableType_Talisman"	"護符"
"[english]DOTA_WearableType_Talisman"	"Talisman"
"DOTA_WearableType_Garland"	"花飾り"
"[english]DOTA_WearableType_Garland"	"Garland"
"DOTA_WearableType_Exort_Cape"	"Exort の肩マント"
"[english]DOTA_WearableType_Exort_Cape"	"Exort Cape"
"DOTA_WearableType_Exort_Bracer"	"Exort 籠手"
"[english]DOTA_WearableType_Exort_Bracer"	"Exort Bracer"
"DOTA_Item"	"装着可能"
"[english]DOTA_Item"	"Wearable"
"DOTA_Custom_Courier"	"クーリエ"
"[english]DOTA_Custom_Courier"	"Courier"
"DOTA_WearableType_Announcer"	"アナウンサー"
"[english]DOTA_WearableType_Announcer"	"Announcer"
"DOTA_WearableType_Custom_Courier"	"クーリエ"
"[english]DOTA_WearableType_Custom_Courier"	"Courier"
"DOTA_WearableType_MegaKills"	""
"[english]DOTA_WearableType_MegaKills"	""
"DOTA_WearableType_Treasure_Chest"	"宝箱"
"[english]DOTA_WearableType_Treasure_Chest"	"Treasure Chest"
"DOTA_TreasureChest_Type"	"宝箱"
"[english]DOTA_TreasureChest_Type"	"Treasure"
"DOTA_WearableType_Tool"	"道具"
"[english]DOTA_WearableType_Tool"	"Tool"
"DOTA_WearableType_Battle_Bonus"	"バトルボーナス"
"[english]DOTA_WearableType_Battle_Bonus"	"Battle Bonus"
"DOTA_Item_Gift"	"ギフト"
"[english]DOTA_Item_Gift"	"Gift"
"DOTA_WearableType_Gift"	"ギフト"
"[english]DOTA_WearableType_Gift"	"Gift"
"DOTA_WearableType_Strange_Essence"	"奇妙なエッセンス"
"[english]DOTA_WearableType_Strange_Essence"	"Strange Essence"
"DOTA_WearableType_LeagueViewPass"	""
"[english]DOTA_WearableType_LeagueViewPass"	""
"DOTA_WearableType_Bundle"	"バンドル"
"[english]DOTA_WearableType_Bundle"	"Bundle"
"DOTA_Wearable_Riki_DefaultWeapon"	"Riki の短剣"
"[english]DOTA_Wearable_Riki_DefaultWeapon"	"Riki's Daggers"
"DOTA_Item_AntiMages_Glaives"	"Anti-Mage's Glaives"
"[english]DOTA_Item_AntiMages_Glaives"	"Anti-Mage's Glaives"
"DOTA_Item_Desc_AntiMages_Glaives"	""
"[english]DOTA_Item_Desc_AntiMages_Glaives"	""
"DOTA_Item_Axes_Axe"	"Axe の斧"
"[english]DOTA_Item_Axes_Axe"	"Axe's Axe"
"DOTA_Wearable_Axe_DefaultArmor"	"Axe の肩当て"
"[english]DOTA_Wearable_Axe_DefaultArmor"	"Axe's Shoulderpad"
"DOTA_Wearable_Axe_DefaultHair"	"Axe のポニーテール"
"[english]DOTA_Wearable_Axe_DefaultHair"	"Axe's Ponytail"
"DOTA_Item_Axes_Belt"	"Axe のベルト"
"[english]DOTA_Item_Axes_Belt"	"Axe's Belt"
"DOTA_Wearable_Jugg_DefaultMask"	"Juggernaut のマスク"
"[english]DOTA_Wearable_Jugg_DefaultMask"	"Juggernaut's Mask"
"DOTA_Wearable_Jugg_DefaultWeapon"	"Juggernaut の武器"
"[english]DOTA_Wearable_Jugg_DefaultWeapon"	"Juggernaut's Weapon"
"DOTA_Wearable_Jugg_DefaultCape"	"Juggernaut の肩マント"
"[english]DOTA_Wearable_Jugg_DefaultCape"	"Juggernaut's Cape"
"DOTA_Wearable_Jugg_DefaultBracers"	"Juggernaut の籠手"
"[english]DOTA_Wearable_Jugg_DefaultBracers"	"Juggernaut's Bracers"
"DOTA_Item_Kunkkas_Boots"	"Kunkka のブーツ"
"[english]DOTA_Item_Kunkkas_Boots"	"Kunkka's Boots"
"DOTA_Item_Kunkkas_Hands"	"Kunkka の両手"
"[english]DOTA_Item_Kunkkas_Hands"	"Kunkka's Hands"
"DOTA_Item_Kunkkas_Sword"	"Kunkka の剣"
"[english]DOTA_Item_Kunkkas_Sword"	"Kunkka's Sword"
"DOTA_Item_Omniknights_Bracers"	"Omniknight の籠手"
"[english]DOTA_Item_Omniknights_Bracers"	"Omniknight's Bracers"
"DOTA_Item_Desc_Bracers"	"Omniknight の古い籠手"
"[english]DOTA_Item_Desc_Bracers"	"Omniknight's old bracers"
"DOTA_Item_Kunkkas_Head"	"Kunkka の頭部"
"[english]DOTA_Item_Kunkkas_Head"	"Kunkka's Head"
"DOTA_FacelessVoid_Default_Weapon"	"Faceless Void の武器"
"[english]DOTA_FacelessVoid_Default_Weapon"	"Faceless Void's Weapon"
"DOTA_Wearable_Sven_DefaultHead"	"Sven の仮面"
"[english]DOTA_Wearable_Sven_DefaultHead"	"Sven's Mask"
"DOTA_Wearable_Sven_DefaultSword"	"Sven's Sword"
"[english]DOTA_Wearable_Sven_DefaultSword"	"Sven's Sword"
"DOTA_Wearable_Sven_DefaultBelt"	"Sven のベルト"
"[english]DOTA_Wearable_Sven_DefaultBelt"	"Sven's Belt"
"DOTA_Wearable_Sven_DefaultGauntlet"	"Sven の篭手"
"[english]DOTA_Wearable_Sven_DefaultGauntlet"	"Sven's Gauntlet"
"DOTA_Wearable_Sven_DefaultShoulder"	"Sven's Shoulder"
"[english]DOTA_Wearable_Sven_DefaultShoulder"	"Sven's Shoulder"
"DOTA_Wearable_Windrunner_DefaultHead"	"Windrunner の頭飾り"
"[english]DOTA_Wearable_Windrunner_DefaultHead"	"Windrunner's Head"
"DOTA_Wearable_Windrunner_DefaultBow"	"Windrunner の弓"
"[english]DOTA_Wearable_Windrunner_DefaultBow"	"Windrunner's Bow"
"DOTA_Wearable_Windrunner_ShoulderPads"	"Windrunner の肩当て"
"[english]DOTA_Wearable_Windrunner_ShoulderPads"	"Windrunner's Shoulder Pads"
"DOTA_Wearable_Windrunner_Cape"	"Windrunner の肩マント"
"[english]DOTA_Wearable_Windrunner_Cape"	"Windrunner's Cape"
"DOTA_Wearable_Windrunner_DefaultQuiver"	"Windrunner の矢筒"
"[english]DOTA_Wearable_Windrunner_DefaultQuiver"	"Windrunner's Quiver"
"DOTA_Item_Queen_of_Pains_Weapon"	"Queen of Pain の武器"
"[english]DOTA_Item_Queen_of_Pains_Weapon"	"Queen of Pain's Weapon"
"DOTA_Wearable_Silencer_DefaultWeapon"	"Silencer の武器"
"[english]DOTA_Wearable_Silencer_DefaultWeapon"	"Silencer's Weapon"
"DOTA_Wearable_Silencer_DefaultShield"	"Silencer のシールド"
"[english]DOTA_Wearable_Silencer_DefaultShield"	"Silencer's Shield"
"DOTA_Wearable_Furion_DefaultWeapon"	"Prophet の杖"
"[english]DOTA_Wearable_Furion_DefaultWeapon"	"Prophet's Staff"
"DOTA_Wearable_Furion_DefaultHorns"	"Prophet の角飾り"
"[english]DOTA_Wearable_Furion_DefaultHorns"	"Prophet's Horns"
"DOTA_Wearable_Furion_DefaultBeard"	"Prophet のあご髭"
"[english]DOTA_Wearable_Furion_DefaultBeard"	"Prophet's Beard"
"DOTA_Wearable_Furion_DefaultCape"	"Prophet の肩マント"
"[english]DOTA_Wearable_Furion_DefaultCape"	"Prophet's Cape"
"DOTA_Wearable_Furion_DefaultNecklace"	"Prophet の首飾り"
"[english]DOTA_Wearable_Furion_DefaultNecklace"	"Prophet's Necklace"
"DOTA_Item_Tidehunters_Bracer"	"Tidehunter の籠手"
"[english]DOTA_Item_Tidehunters_Bracer"	"Tidehunter's Bracer"
"DOTA_Item_Tidehunters_Belt"	"Tidehunter のベルト"
"[english]DOTA_Item_Tidehunters_Belt"	"Tidehunter's Belt"
"DOTA_Item_Tidehunters_Anchor"	"Tidehunter の錨"
"[english]DOTA_Item_Tidehunters_Anchor"	"Tidehunter's Anchor"
"DOTA_Item_Tidehunters_Lunch"	"Tidehunter の昼食"
"[english]DOTA_Item_Tidehunters_Lunch"	"Tidehunter's Lunch"
"DOTA_Wearable_CrystalMaiden_Default_Cape"	"Crystal Maiden の肩マント"
"[english]DOTA_Wearable_CrystalMaiden_Default_Cape"	"Crystal Maiden's Cape"
"DOTA_Wearable_CrystalMaiden_Default_Shoulder_Pads"	"Crystal Maiden の肩当て"
"[english]DOTA_Wearable_CrystalMaiden_Default_Shoulder_Pads"	"Crystal Maiden's Shoulder Pads"
"DOTA_Wearable_CrystalMaiden_Default_Weapon"	"Crystal Maiden の武器"
"[english]DOTA_Wearable_CrystalMaiden_Default_Weapon"	"Crystal Maiden's Weapon"
"DOTA_Wearable_CrystalMaiden_Default_Boots_and_Cuffs"	"Crystal Maiden's Boots & Cuffs"
"[english]DOTA_Wearable_CrystalMaiden_Default_Boots_and_Cuffs"	"Crystal Maiden's Boots & Cuffs"
"DOTA_Item_Omniknights_Shoulders"	"Omniknight の肩部"
"[english]DOTA_Item_Omniknights_Shoulders"	"Omniknight's Shoulders"
"DOTA_Item_Desc_Omniknights_Shoulders"	"Omniknight の古式肩部"
"[english]DOTA_Item_Desc_Omniknights_Shoulders"	"Omniknight's old shoulders"
"DOTA_Item_Omniknights_Cape"	"Omniknight の肩マント"
"[english]DOTA_Item_Omniknights_Cape"	"Omniknight's Cape"
"DOTA_Item_Desc_Omniknights_Cape"	"Omniknight の古い肩マント"
"[english]DOTA_Item_Desc_Omniknights_Cape"	"Omniknight's old cape"
"DOTA_Item_Omniknights_Weapon"	"Omniknight の武器"
"[english]DOTA_Item_Omniknights_Weapon"	"Omniknight's Weapon"
"DOTA_Item_Desc_Omniknights_Hammer"	"Omniknight　の古いハンマー"
"[english]DOTA_Item_Desc_Omniknights_Hammer"	"Omniknight's old hammer"
"DOTA_Item_Omniknights_Head"	"Omniknight の頭部"
"[english]DOTA_Item_Omniknights_Head"	"Omniknight's Head"
"DOTA_Item_Desc_Omniknights_Head"	"Omniknight　のかつての顔"
"[english]DOTA_Item_Desc_Omniknights_Head"	"Omniknight's old face"
"DOTA_Item_Omniknights_Hair"	"Omniknight の髪型"
"[english]DOTA_Item_Omniknights_Hair"	"Omniknight's Hair"
"DOTA_Item_Desc_Omniknights_Hair"	"Omniknight の以前の髪型"
"[english]DOTA_Item_Desc_Omniknights_Hair"	"Omniknight's old hair"
"DOTA_Item_Pudges_Rusty_Meathook"	"Pudge's 錆びた食肉用の搬送フック"
"[english]DOTA_Item_Pudges_Rusty_Meathook"	"Pudge's Rusty Meathook"
"DOTA_Item_Desc_Rusty_Meathook"	"錆び付いてむごい、食肉の搬送用フック
"
"[english]DOTA_Item_Desc_Rusty_Meathook"	"A rusted and cruel looking meat hook."
"DOTA_Item_Invokers_Cape"	"Invoker の肩マント"
"[english]DOTA_Item_Invokers_Cape"	"Invoker's Cape"
"DOTA_Item_Desc_Invokers_Cape"	""
"[english]DOTA_Item_Desc_Invokers_Cape"	""
"DOTA_Item_Prophets_Bracers"	"Prophet の籠手"
"[english]DOTA_Item_Prophets_Bracers"	"Prophet's Bracers"
"DOTA_Item_Desc_Copy_of_Prophets_Horns"	""
"[english]DOTA_Item_Desc_Copy_of_Prophets_Horns"	""
"DOTA_Item_Bounty_Hunters_Weapon"	"Bounty Hunter の武器"
"[english]DOTA_Item_Bounty_Hunters_Weapon"	"Bounty Hunter's Weapon"
"DOTA_Item_Desc_Unnamed_New_Item"	"この新しいアイテムには説明がありません。"
"[english]DOTA_Item_Desc_Unnamed_New_Item"	"This new item has no description."
"DOTA_Item_Bounty_Hunters_Offhand_Weapon"	"Bounty Hunter 逆腕の武器"
"[english]DOTA_Item_Bounty_Hunters_Offhand_Weapon"	"Bounty Hunter's Offhand Weapon"
"DOTA_Item_Desc_Copy_of_RWeapon"	"この新しいアイテムには説明がありません。"
"[english]DOTA_Item_Desc_Copy_of_RWeapon"	"This new item has no description."
"DOTA_Item_Bounty_Hunters_Back"	"Bounty Hunter の背部"
"[english]DOTA_Item_Bounty_Hunters_Back"	"Bounty Hunter's Back"
"DOTA_Item_Desc_Copy_of_LWeapon"	"この新しいアイテムには説明がありません。"
"[english]DOTA_Item_Desc_Copy_of_LWeapon"	"This new item has no description."
"DOTA_Item_Armor"	"Bounty Hunter の鎧"
"[english]DOTA_Item_Armor"	"Bounty Hunter's Armor"
"DOTA_Item_Desc_Copy_of_Backpack"	"この新しいアイテムには説明がありません。"
"[english]DOTA_Item_Desc_Copy_of_Backpack"	"This new item has no description."
"DOTA_Item_Bounty_Hunters_Shoulder"	"Bounty Hunter の肩部"
"[english]DOTA_Item_Bounty_Hunters_Shoulder"	"Bounty Hunter's Shoulder"
"DOTA_Item_Desc_Copy_of_Armor"	"この新しいアイテムには説明がありません。"
"[english]DOTA_Item_Desc_Copy_of_Armor"	"This new item has no description."
"DOTA_Item_Bounty_Hunters_Bandana"	"Bounty Hunter のバンダナ"
"[english]DOTA_Item_Bounty_Hunters_Bandana"	"Bounty Hunter's Bandana"
"DOTA_Item_Desc_Copy_of_BWeapon"	"この新しいアイテムには説明がありません。"
"[english]DOTA_Item_Desc_Copy_of_BWeapon"	"This new item has no description."
"DOTA_Item_Clinkz_Skull"	"Clinkz の頭蓋骨"
"[english]DOTA_Item_Clinkz_Skull"	"Clinkz Skull"
"DOTA_Item_Desc_Clinkz_Skull"	"Clinkz の頭蓋骨（ディフォルト）"
"[english]DOTA_Item_Desc_Clinkz_Skull"	"Clinkz default skull"
"DOTA_Item_Clinkz_Bow"	"Clinkz の弓"
"[english]DOTA_Item_Clinkz_Bow"	"Clinkz Bow"
"DOTA_Item_Desc_Clinkz_Bow"	"Clinkz の弓（ディフォルト）"
"[english]DOTA_Item_Desc_Clinkz_Bow"	"Clinkz default Bow"
"DOTA_Item_Clinkz_Shoulder_Pads"	"Clinkz の肩当て"
"[english]DOTA_Item_Clinkz_Shoulder_Pads"	"Clinkz Shoulder Pads"
"DOTA_Item_Desc_Clinkz_Shoulder_Pads"	"Clinkz の肩当て（ディフォルト）"
"[english]DOTA_Item_Desc_Clinkz_Shoulder_Pads"	"Clinkz default Shoulder Pads"
"DOTA_Item_Clinkz_Quiver"	"Clinkz の矢筒"
"[english]DOTA_Item_Clinkz_Quiver"	"Clinkz Quiver"
"DOTA_Item_Desc_Clinkz_Quiver"	"Clinkz の矢筒（ディフォルト）"
"[english]DOTA_Item_Desc_Clinkz_Quiver"	"Clinkz default Quiver"
"DOTA_Item_Clinkz_Horns"	"Clinkz の角"
"[english]DOTA_Item_Clinkz_Horns"	"Clinkz Horns"
"DOTA_Item_Desc_Clinkz_Horns"	"Clinkz の角（ディフォルト）"
"[english]DOTA_Item_Desc_Clinkz_Horns"	"Clinkz default horns"
"DOTA_Item_Clinkz_Gloves"	"Clinkz の手袋"
"[english]DOTA_Item_Clinkz_Gloves"	"Clinkz Gloves"
"DOTA_Item_Desc_Copy_of_Clinkz_Skull"	"Clinkz スカル（ディフォルト）"
"[english]DOTA_Item_Desc_Copy_of_Clinkz_Skull"	"Clinkz default skull"
"DOTA_Wearable_Jugg_DefaultLegs"	"Juggernaut の脚部"
"[english]DOTA_Wearable_Jugg_DefaultLegs"	"Juggernaut's Legs"
"DOTA_Item_Dragon_Knights_Helmet"	"Dragon Knight の兜"
"[english]DOTA_Item_Dragon_Knights_Helmet"	"Dragon Knight's Helmet"
"DOTA_Item_Desc_Copy_of_Juggernauts_Legs"	""
"[english]DOTA_Item_Desc_Copy_of_Juggernauts_Legs"	""
"DOTA_Item_Dragon_Knights_Shoulder_Armor"	"Dragon Knight の肩鎧"
"[english]DOTA_Item_Dragon_Knights_Shoulder_Armor"	"Dragon Knight's Shoulder Armor"
"DOTA_Item_Desc_Dragon_Knights_Shoulder_Armor"	""
"[english]DOTA_Item_Desc_Dragon_Knights_Shoulder_Armor"	""
"DOTA_Item_Dragon_Knights_Bracers"	"Dragon Knight の籠手"
"[english]DOTA_Item_Dragon_Knights_Bracers"	"Dragon Knight's Bracers"
"DOTA_Item_Desc_Copy_of_Dragon_Knights_Shoulder_Armor"	""
"[english]DOTA_Item_Desc_Copy_of_Dragon_Knights_Shoulder_Armor"	""
"DOTA_Item_Dragon_Knights_Weapon"	"Dragon Knight の武器"
"[english]DOTA_Item_Dragon_Knights_Weapon"	"Dragon Knight's Weapon"
"DOTA_Item_Desc_Dragon_Knights_Weapon"	""
"[english]DOTA_Item_Desc_Dragon_Knights_Weapon"	""
"DOTA_Item_Dragon_Knights_Offhand"	"Dragon Knight の逆腕"
"[english]DOTA_Item_Dragon_Knights_Offhand"	"Dragon Knight's Offhand"
"DOTA_Item_Desc_Dragon_Knights_Offhand"	""
"[english]DOTA_Item_Desc_Dragon_Knights_Offhand"	""
"DOTA_Item_Dragon_Knights_Skirt"	"Dragon Knight のスカート"
"[english]DOTA_Item_Dragon_Knights_Skirt"	"Dragon Knight's Skirt"
"DOTA_Item_Desc_Copy_of_Dragon_Knights_Offhand"	""
"[english]DOTA_Item_Desc_Copy_of_Dragon_Knights_Offhand"	""
"DOTA_Item_Blood_Seekers_Weapon"	"Bloodseeker の武器"
"[english]DOTA_Item_Blood_Seekers_Weapon"	"Blood Seeker's Weapon"
"DOTA_Item_Desc_Copy_of_Dragon_Knights_Skirt"	""
"[english]DOTA_Item_Desc_Copy_of_Dragon_Knights_Skirt"	""
"DOTA_Item_Blood_Seekers_Headdress"	"Bloodseeker の頭飾り"
"[english]DOTA_Item_Blood_Seekers_Headdress"	"Blood Seeker's Headdress"
"DOTA_Item_Desc_Blood_Seekers_Headdress"	""
"[english]DOTA_Item_Desc_Blood_Seekers_Headdress"	""
"DOTA_Item_Blood_Seekers_Offhand_Weapon"	"Bloodseeker の左手の武器"
"[english]DOTA_Item_Blood_Seekers_Offhand_Weapon"	"Blood Seeker's Offhand Weapon"
"DOTA_Item_Desc_Copy_of_Blood_Seekers_Headdress"	""
"[english]DOTA_Item_Desc_Copy_of_Blood_Seekers_Headdress"	""
"DOTA_Item_Blood_Seekers_Necklace"	"BloodSeeker の首飾り"
"[english]DOTA_Item_Blood_Seekers_Necklace"	"Blood Seeker's Necklace"
"DOTA_Item_Desc_Copy_of_Blood_Seekers_Offhand_Weapon"	""
"[english]DOTA_Item_Desc_Copy_of_Blood_Seekers_Offhand_Weapon"	""
"DOTA_Item_Blood_Seekers_Cape"	"Bloodseeker の肩マント"
"[english]DOTA_Item_Blood_Seekers_Cape"	"Blood Seeker's Cape"
"DOTA_Item_Desc_Copy_of_Blood_Seekers_Necklace"	""
"[english]DOTA_Item_Desc_Copy_of_Blood_Seekers_Necklace"	""
"DOTA_Item_Blood_Seekers_Bracers"	"Bloodseeker の籠手"
"[english]DOTA_Item_Blood_Seekers_Bracers"	"Blood Seeker's Bracers"
"DOTA_Item_Desc_Copy_of_Blood_Seekers_Cape"	""
"[english]DOTA_Item_Desc_Copy_of_Blood_Seekers_Cape"	""
"DOTA_Item_Drows_Bracers"	"Drow の籠手"
"[english]DOTA_Item_Drows_Bracers"	"Drow's Bracers"
"DOTA_Item_Desc_Copy_of_Blood_Seekers_Bracers"	""
"[english]DOTA_Item_Desc_Copy_of_Blood_Seekers_Bracers"	""
"DOTA_Item_Drows_Cape"	"Drow の肩マント"
"[english]DOTA_Item_Drows_Cape"	"Drow's Cape"
"DOTA_Item_Desc_Copy_of_Drows_Bracers"	""
"[english]DOTA_Item_Desc_Copy_of_Drows_Bracers"	""
"DOTA_Item_Drows_Bow"	"Drow の弓"
"[english]DOTA_Item_Drows_Bow"	"Drow's Bow"
"DOTA_Item_Desc_Copy_of_Drows_Cape"	""
"[english]DOTA_Item_Desc_Copy_of_Drows_Cape"	""
"DOTA_Item_Drows_Leg_Armor"	"Drow の脚鎧"
"[english]DOTA_Item_Drows_Leg_Armor"	"Drow's Leg Armor"
"DOTA_Item_Desc_Drows_Leg_Armor"	""
"[english]DOTA_Item_Desc_Drows_Leg_Armor"	""
"DOTA_Item_Drows_Quiver"	"Drow の矢筒"
"[english]DOTA_Item_Drows_Quiver"	"Drow's Quiver"
"DOTA_Item_Desc_Copy_of_Drows_Leg_Armor"	""
"[english]DOTA_Item_Desc_Copy_of_Drows_Leg_Armor"	""
"DOTA_Item_Drows_Shoulder_Armor"	"Drow の肩鎧"
"[english]DOTA_Item_Drows_Shoulder_Armor"	"Drow's Shoulder Armor"
"DOTA_Item_Desc_Copy_of_Drows_Quiver"	""
"[english]DOTA_Item_Desc_Copy_of_Drows_Quiver"	""
"DOTA_Item_Kunkkas_Spyglass"	"Kunkka の望遠鏡"
"[english]DOTA_Item_Kunkkas_Spyglass"	"Kunkka's Spyglass"
"DOTA_Item_Desc_Copy_of_Kunkkas_Head"	""
"[english]DOTA_Item_Desc_Copy_of_Kunkkas_Head"	""
"DOTA_Item_Queen_of_Pains_Wings"	"Queen of Pain の翼"
"[english]DOTA_Item_Queen_of_Pains_Wings"	"Queen of Pain's Wings"
"DOTA_Item_Desc_Copy_of_Queen_of_Pains_Weapon"	""
"[english]DOTA_Item_Desc_Copy_of_Queen_of_Pains_Weapon"	""
"DOTA_Item_Queen_of_Pains_Armor"	"Queen of Pain の鎧"
"[english]DOTA_Item_Queen_of_Pains_Armor"	"Queen of Pain's Armor"
"DOTA_Item_Desc_Copy_of_Queen_of_Pains_Wings"	""
"[english]DOTA_Item_Desc_Copy_of_Queen_of_Pains_Wings"	""
"DOTA_Item_Queen_of_Pains_Hair"	"Queen of Pain の髪型"
"[english]DOTA_Item_Queen_of_Pains_Hair"	"Queen of Pain's Hair"
"DOTA_Item_Desc_Copy_of_Queen_of_Pains_Armor"	""
"[english]DOTA_Item_Desc_Copy_of_Queen_of_Pains_Armor"	""
"DOTA_Item_Ursas_Helmet"	"Ursa の兜"
"[english]DOTA_Item_Ursas_Helmet"	"Ursa's Helmet"
"DOTA_Item_Desc_Copy_of_Queen_of_Pains_Hair"	""
"[english]DOTA_Item_Desc_Copy_of_Queen_of_Pains_Hair"	""
"DOTA_Item_Ursas_Fur"	"Ursa の毛皮"
"[english]DOTA_Item_Ursas_Fur"	"Ursa's Fur"
"DOTA_Item_Desc_Copy_of_Ursas_Helmet"	""
"[english]DOTA_Item_Desc_Copy_of_Ursas_Helmet"	""
"DOTA_Item_Ursas_Bracers"	"Ursa の籠手"
"[english]DOTA_Item_Ursas_Bracers"	"Ursa's Bracers"
"DOTA_Item_Desc_Copy_of_Ursas_Fur"	""
"[english]DOTA_Item_Desc_Copy_of_Ursas_Fur"	""
"DOTA_Item_Ursas_Skirt"	"Ursa のスカート"
"[english]DOTA_Item_Ursas_Skirt"	"Ursa's Skirt"
"DOTA_Item_Desc_Copy_of_Ursas_Bracers"	""
"[english]DOTA_Item_Desc_Copy_of_Ursas_Bracers"	""
"DOTA_Item_Invokers_Shoulder"	"Invoker の肩部"
"[english]DOTA_Item_Invokers_Shoulder"	"Invoker's Shoulder"
"DOTA_Item_Facelesss_Head"	"Faceless　の頭部"
"[english]DOTA_Item_Facelesss_Head"	"Faceless's Head"
"DOTA_Item_Facelesss_Shoulder"	"Faceless の肩部"
"[english]DOTA_Item_Facelesss_Shoulder"	"Faceless's Shoulder"
"DOTA_Item_Facelesss_Bracer"	"Faceless の籠手"
"[english]DOTA_Item_Facelesss_Bracer"	"Faceless's Bracer"
"DOTA_Item_Facelesss_Belt"	"Faceless のベルト"
"[english]DOTA_Item_Facelesss_Belt"	"Faceless's Belt"
"DOTA_Item_Witch_Doctors_Head"	"Witch Doctor の頭部"
"[english]DOTA_Item_Witch_Doctors_Head"	"Witch Doctor's Head"
"DOTA_Item_Witch_Doctors_Bag"	"Witch Doctor のバッグ"
"[english]DOTA_Item_Witch_Doctors_Bag"	"Witch Doctor's Bag"
"DOTA_Item_Witch_Doctors_Belt"	"Witch Doctor のベルト"
"[english]DOTA_Item_Witch_Doctors_Belt"	"Witch Doctor's Belt"
"DOTA_Item_Witch_Doctors_Staff"	"Witch Doctor の杖"
"[english]DOTA_Item_Witch_Doctors_Staff"	"Witch Doctor's Staff"
"DOTA_Item_Invokers_Head"	"Invoker の頭部"
"[english]DOTA_Item_Invokers_Head"	"Invoker's Head"
"DOTA_Item_Invokers_Hair"	"Invoker の髪型"
"[english]DOTA_Item_Invokers_Hair"	"Invoker's Hair"
"DOTA_Item_Invokers_Bracer"	"Invoker の籠手"
"[english]DOTA_Item_Invokers_Bracer"	"Invoker's Bracer"
"DOTA_Item_Broodmothers_Hair"	"Broodmother の毛"
"[english]DOTA_Item_Broodmothers_Hair"	"Broodmother's Hair"
"DOTA_Item_Broodmothers_Legs"	"Broodmother の脚部"
"[english]DOTA_Item_Broodmothers_Legs"	"Broodmother's Legs"
"DOTA_Item_Broodmothers_Abdomen"	"Broodmother の腹部"
"[english]DOTA_Item_Broodmothers_Abdomen"	"Broodmother's Abdomen"
"DOTA_Item_Meepos_Weapon"	"Meepo の武器"
"[english]DOTA_Item_Meepos_Weapon"	"Meepo's Weapon"
"DOTA_Item_Ogremagis_Weapon"	"Ogremagi の武器"
"[english]DOTA_Item_Ogremagis_Weapon"	"Ogremagi's Weapon"
"DOTA_Item_Desc_Copy_of_weapon"	"この新しいアイテムには説明がありません。"
"[english]DOTA_Item_Desc_Copy_of_weapon"	"This new item has no description."
"DOTA_Item_Spirit_Breakers_Head"	"Spirit Breaker の頭部"
"[english]DOTA_Item_Spirit_Breakers_Head"	"Spirit Breaker's Head"
"DOTA_Item_Desc_Spirit_Breakers_Head"	"この新しいアイテムには説明がありません。"
"[english]DOTA_Item_Desc_Spirit_Breakers_Head"	"This new item has no description."
"DOTA_Item_Lone_Druids_Hair"	"Lone Druid の髪型"
"[english]DOTA_Item_Lone_Druids_Hair"	"Lone Druid's Hair"
"DOTA_Item_Desc_head"	"髪型（ディフォルト）"
"[english]DOTA_Item_Desc_head"	"default hair"
"DOTA_Item_Lone_Druids_Shoulder_Armor"	"Lone Druid の肩鎧"
"[english]DOTA_Item_Lone_Druids_Shoulder_Armor"	"Lone Druid's Shoulder Armor"
"DOTA_Item_Desc_Lone_Druids_Shoulder_Armor"	"初期設定の肩鎧"
"[english]DOTA_Item_Desc_Lone_Druids_Shoulder_Armor"	"default shoulder armor"
"DOTA_Item_Lone_Druids_Bracers"	"Lone Druid の籠手"
"[english]DOTA_Item_Lone_Druids_Bracers"	"Lone Druid's Bracers"
"DOTA_Item_Desc_Lone_Druids_Bracers"	"腕用アイテム（初期設定）"
"[english]DOTA_Item_Desc_Lone_Druids_Bracers"	"default arm item"
"DOTA_Item_Lone_Druids_Poncho"	"Lone Druid のポンチョ"
"[english]DOTA_Item_Lone_Druids_Poncho"	"Lone Druid's Poncho"
"DOTA_Item_Desc_Lone_Druids_Poncho"	"初期設定の体部のアイテム"
"[english]DOTA_Item_Desc_Lone_Druids_Poncho"	"default body item"
"DOTA_Item_Spirit_Breakers_Horns"	"Spirit Breaker の角"
"[english]DOTA_Item_Spirit_Breakers_Horns"	"Spirit Breaker's Horns"
"DOTA_Item_Desc_Copy_of_Spirit_Breakers_Head"	"この新しいアイテムには説明がありません。"
"[english]DOTA_Item_Desc_Copy_of_Spirit_Breakers_Head"	"This new item has no description."
"DOTA_Item_Spirit_Breakers_Shoulder_Armor"	"Spirit Breaker の肩鎧"
"[english]DOTA_Item_Spirit_Breakers_Shoulder_Armor"	"Spirit Breaker's Shoulder Armor"
"DOTA_Item_Desc_Copy_of_Spirit_Breakers_Horns"	"この新しいアイテムには説明がありません。"
"[english]DOTA_Item_Desc_Copy_of_Spirit_Breakers_Horns"	"This new item has no description."
"DOTA_Item_Spirit_Breakers_Mace"	"Spirit Breaker の槌矛"
"[english]DOTA_Item_Spirit_Breakers_Mace"	"Spirit Breaker's Mace"
"DOTA_Item_Desc_Copy_of_Spirit_Breakers_Shoulder_Armor"	"この新しいアイテムには説明がありません。"
"[english]DOTA_Item_Desc_Copy_of_Spirit_Breakers_Shoulder_Armor"	"This new item has no description."
"DOTA_Item_Spirit_Breakers_Tail"	"Spirit Breaker の尾"
"[english]DOTA_Item_Spirit_Breakers_Tail"	"Spirit Breaker's Tail"
"DOTA_Item_Desc_Copy_of_Spirit_Breakers_Mace"	"この新しいアイテムには説明がありません。"
"[english]DOTA_Item_Desc_Copy_of_Spirit_Breakers_Mace"	"This new item has no description."
"DOTA_Item_Spirit_Breakers_Bracers"	"Spirit Breaker の籠手"
"[english]DOTA_Item_Spirit_Breakers_Bracers"	"Spirit Breaker's Bracers"
"DOTA_Item_Desc_Copy_of_Spirit_Breakers_Tail"	"この新しいアイテムには説明がありません。"
"[english]DOTA_Item_Desc_Copy_of_Spirit_Breakers_Tail"	"This new item has no description."
"DOTA_Item_Spirit_Breakers_Lower_Armor"	"Spirit Breaker の下半身鎧"
"[english]DOTA_Item_Spirit_Breakers_Lower_Armor"	"Spirit Breaker's Lower Armor"
"DOTA_Item_Desc_Copy_of_Spirit_Breakers_Bracers"	"この新しいアイテムには説明がありません。"
"[english]DOTA_Item_Desc_Copy_of_Spirit_Breakers_Bracers"	"This new item has no description."
"DOTA_Item_Alchemists_Weapon"	"Alchemist の武器"
"[english]DOTA_Item_Alchemists_Weapon"	"Alchemist's Weapon"
"DOTA_Item_Alchemists_Saddle"	"Alchemist の鞍"
"[english]DOTA_Item_Alchemists_Saddle"	"Alchemist's Saddle"
"DOTA_Item_Alchemists_Gauntlet"	"Alchemist の篭手"
"[english]DOTA_Item_Alchemists_Gauntlet"	"Alchemist's Gauntlet"
"DOTA_Item_Alchemists_Goblin_Hat"	"Alchemist のゴブリン帽子"
"[english]DOTA_Item_Alchemists_Goblin_Hat"	"Alchemist's Goblin Hat"
"DOTA_Item_Alchemists_Goblin_Head"	"Alchemist のゴブリンの頭部"
"[english]DOTA_Item_Alchemists_Goblin_Head"	"Alchemist's Goblin Head"
"DOTA_Item_Alchemists_Ogre_Head"	"Alchemist のOgre の頭部"
"[english]DOTA_Item_Alchemists_Ogre_Head"	"Alchemist's Ogre Head"
"DOTA_Item_Phantom_Lancers_Legs"	"Phantom Lancer の脚"
"[english]DOTA_Item_Phantom_Lancers_Legs"	"Phantom Lancer's Legs"
"DOTA_Item_Desc_Phantom_Lancers_Legs"	"この靴は歩くために。"
"[english]DOTA_Item_Desc_Phantom_Lancers_Legs"	"These boots were made for walkin'."
"DOTA_Item_Phantom_Lancers_Head"	"Phantom Lancer の頭部"
"[english]DOTA_Item_Phantom_Lancers_Head"	"Phantom Lancer's Head"
"DOTA_Item_Phantom_Lancers_Belt"	"Phantom Lancer のベルト"
"[english]DOTA_Item_Phantom_Lancers_Belt"	"Phantom Lancer's Belt"
"DOTA_Item_Phantom_Lancers_Gauntlet"	"Phantom Lancer の篭手"
"[english]DOTA_Item_Phantom_Lancers_Gauntlet"	"Phantom Lancer's Gauntlet"
"DOTA_Item_Phantom_Lancers_Shoulderpad"	"Phantom Lancer の肩鎧"
"[english]DOTA_Item_Phantom_Lancers_Shoulderpad"	"Phantom Lancer's Shoulderpad"
"DOTA_Item_Phantom_Lancers_Necklace"	"Phantom Lancer の首輪"
"[english]DOTA_Item_Phantom_Lancers_Necklace"	"Phantom Lancer's Necklace"
"DOTA_Item_Phantom_Lancers_Weapon"	"Phantom Lancer の武器"
"[english]DOTA_Item_Phantom_Lancers_Weapon"	"Phantom Lancer's Weapon"
"DOTA_Item_Desc_Phantom_Lancers_Weapon"	"突き刺す用。"
"[english]DOTA_Item_Desc_Phantom_Lancers_Weapon"	"For stabbin'."
"DOTA_Item_Ogremagis_Cape"	"Ogremagi の肩マント"
"[english]DOTA_Item_Ogremagis_Cape"	"Ogremagi's Cape"
"DOTA_Item_Desc_Copy_of_Ogremagis_Weapon"	"この新しいアイテムには説明がありません。"
"[english]DOTA_Item_Desc_Copy_of_Ogremagis_Weapon"	"This new item has no description."
"DOTA_Item_Ogremagis_Bracers"	"Ogremagi の籠手"
"[english]DOTA_Item_Ogremagis_Bracers"	"Ogremagi's Bracers"
"DOTA_Item_Desc_Copy_of_Ogremagis_Cape"	"この新しいアイテムには説明がありません。"
"[english]DOTA_Item_Desc_Copy_of_Ogremagis_Cape"	"This new item has no description."
"DOTA_Item_Ogremagis_Hats"	"Ogremagi の帽子"
"[english]DOTA_Item_Ogremagis_Hats"	"Ogremagi's Hats"
"DOTA_Item_Desc_Copy_of_Ogremagis_Bracers"	"この新しいアイテムには説明がありません。"
"[english]DOTA_Item_Desc_Copy_of_Ogremagis_Bracers"	"This new item has no description."
"DOTA_Item_Ogremagis_Belt"	"Ogremagi のベルト"
"[english]DOTA_Item_Ogremagis_Belt"	"Ogremagi's Belt"
"DOTA_Item_Desc_Copy_of_Ogremagis_Hats"	"この新しいアイテムには説明がありません。"
"[english]DOTA_Item_Desc_Copy_of_Ogremagis_Hats"	"This new item has no description."
"DOTA_Item_Wich_Doctors_Horn_Mask"	"Wich Doctor's Horn Mask"
"[english]DOTA_Item_Wich_Doctors_Horn_Mask"	"Wich Doctor's Horn Mask"
"DOTA_Item_Pangolin_Shoulder_Armor"	"Pangolin の肩鎧"
"[english]DOTA_Item_Pangolin_Shoulder_Armor"	"Pangolin Shoulder Armor"
"DOTA_Wearable_Dazzle_TrolltoothNecklace"	"トロールの歯の首輪"
"[english]DOTA_Wearable_Dazzle_TrolltoothNecklace"	"Trolltooth Necklace"
"DOTA_Wearable_Dazzle_TrolltoothNecklace_Desc"	"トロールの歯を丁寧につなげて作られた。それぞれの歯は以前の持ち主の魂を閉じ込めている。"
"[english]DOTA_Wearable_Dazzle_TrolltoothNecklace_Desc"	"A carefully assembled collection of troll's teeth. Each tooth contains the trapped soul of its former owner."
"DOTA_Wearable_Kunkka_Pegleg"	"Pegleg of the Cursed Pirate"
"[english]DOTA_Wearable_Kunkka_Pegleg"	"Pegleg of the Cursed Pirate"
"DOTA_Item_Desc_Pegleg_of_the_Cursed_Pirate"	"片足を失おうとも Kunkka の復讐への欲求を妨げることはできない。"
"[english]DOTA_Item_Desc_Pegleg_of_the_Cursed_Pirate"	"A lost foot does not hinder Kunkka's desire for vengeance."
"DOTA_Wearable_Kunkka_Bandana"	"Pride of the Crew"
"[english]DOTA_Wearable_Kunkka_Bandana"	"Pride of the Crew"
"DOTA_Wearable_Kunkka_Bicorne_Hat"	"Royal Admiral's Bicorne"
"[english]DOTA_Wearable_Kunkka_Bicorne_Hat"	"Royal Admiral's Bicorne"
"DOTA_Wearable_Kunkka_Tricorne_Hat"	"Tricorne of the Drowned"
"[english]DOTA_Wearable_Kunkka_Tricorne_Hat"	"Tricorne of the Drowned"
"DOTA_Wearable_Kunkka_Wavecrester"	"Wavecrester"
"[english]DOTA_Wearable_Kunkka_Wavecrester"	"Wavecrester"
"DOTA_Wearable_Axe_Berserkers_Pauldron"	"Berserker の肩甲"
"[english]DOTA_Wearable_Axe_Berserkers_Pauldron"	"Berserker's Pauldron"
"DOTA_Wearable_Axe_Berserkers_Helm"	"Berserker の兜"
"[english]DOTA_Wearable_Axe_Berserkers_Helm"	"Berserker's Helm"
"DOTA_Wearable_Axe_Berserkers_Belt"	"Berserker のベルト"
"[english]DOTA_Wearable_Axe_Berserkers_Belt"	"Berserker's Belt"
"DOTA_Item_Desc_Berserkers_Belt"	"「虐殺の始まりだ」"
"[english]DOTA_Item_Desc_Berserkers_Belt"	"\"Let the carnage begin.\""
"DOTA_Item_Taunt_Snipers_Celebration"	"挑発: Sniper's Celebration"
"[english]DOTA_Item_Taunt_Snipers_Celebration"	"Taunt: Sniper's Celebration"
"DOTA_AnimTaunt_SniperTaunt_Desc"	"キルやファインプレーの達成を祝いつつ、あなたの興奮を敵に見せ付けてやりましょう。相手は気にしないはずですよ。"
"[english]DOTA_AnimTaunt_SniperTaunt_Desc"	"Celebrate a sweet kill or a big play by showing your excitement to your enemy. He won't mind."
"DOTA_Item_Taunt_Beautiful_Snowangel"	"挑発: 美しきスノーエンジェル"
"[english]DOTA_Item_Taunt_Beautiful_Snowangel"	"Taunt: Beautiful Snowangel"
"DOTA_AnimTaunt_CM_Snowangel_Desc"	"Crystal Maiden がスノーエンジェルを作った！"
"[english]DOTA_AnimTaunt_CM_Snowangel_Desc"	"Crystal Maiden makes a snowangel!"
"DOTA_Item_Taunt_Playful_Snowball"	"挑発: 楽しい雪合戦"
"[english]DOTA_Item_Taunt_Playful_Snowball"	"Taunt: Playful Snowball"
"DOTA_AnimTaunt_CM_Snowball_Desc"	"Crystal Maiden が雪玉を放った！"
"[english]DOTA_AnimTaunt_CM_Snowball_Desc"	"Crystal Maiden throws a snowball!"
"DOTA_Item_Taunt_Come_and_Get_It"	"挑発: かかってこい！"
"[english]DOTA_Item_Taunt_Come_and_Get_It"	"Taunt: Come and Get It!"
"DOTA_Item_Desc_Taunt_Come_and_Get_It"	""
"[english]DOTA_Item_Desc_Taunt_Come_and_Get_It"	"Axe requests more fools to slaughter!"
"DOTA_Item_Taunt_Spider_Shuffle"	"挑発: 蜘蛛ダンス"
"[english]DOTA_Item_Taunt_Spider_Shuffle"	"Taunt: Spider Shuffle"
"DOTA_AnimTaunt_Broodmother_Spin_Desc"	"Broodmother スピン挑発"
"[english]DOTA_AnimTaunt_Broodmother_Spin_Desc"	"Broodmother Spin Taunt"
"DOTA_Item_Desc_Taunt_Good_Day_Sir"	""
"[english]DOTA_Item_Desc_Taunt_Good_Day_Sir"	""
"DOTA_AnimTaunt_Jakiro_Roar_Desc"	"Jakiro Roar 挑発"
"[english]DOTA_AnimTaunt_Jakiro_Roar_Desc"	"Jakiro Roar Taunt"
"DOTA_AnimTaunt_Jakiro_Icemelt_Desc"	"Jakiro Icemelt 挑発"
"[english]DOTA_AnimTaunt_Jakiro_Icemelt_Desc"	"Jakiro Icemelt Taunt"
"DOTA_AnimTaunt_Tidehunter_Toss_Fish_Desc"	""
"[english]DOTA_AnimTaunt_Tidehunter_Toss_Fish_Desc"	""
"DOTA_Item_Desc_Lina_Taunt__Get_Burned"	"挑発 - お焦げなさい。"
"[english]DOTA_Item_Desc_Lina_Taunt__Get_Burned"	"Taunt - Get Burned."
"DOTA_Item_Desc_Belly_Flop"	"アルティメットを使用中に、腹打ち飛び込みするチャンスを与える。"
"[english]DOTA_Item_Desc_Belly_Flop"	"Gives Tidehunter a chance to belly flop when using his ultimate."
"DOTA_Item_Desc_Attack_Fish_Slap"	"代替の通常攻撃アニメーションを与える。"
"[english]DOTA_Item_Desc_Attack_Fish_Slap"	"Gives Tidehunter an alternate default attack animation."
"DOTA_Item_Desc_Taunt_For_Death_and_Honor"	"敵の名誉ある死に対する敬意を示しましょう。使用するには、このアイテムを装備し、'挑発アイテム'ボタンにキーをバインドします。"
"[english]DOTA_Item_Desc_Taunt_For_Death_and_Honor"	"Show your enemy your respect for their honorable deaths."
"DOTA_Item_Desc_Taunt_Face_the_Juggernaut"	"名誉ある戦闘での死を受け入れるために敵を招待する。"
"[english]DOTA_Item_Desc_Taunt_Face_the_Juggernaut"	"Invite your enemy to embrace their death in honorable combat."
"DOTA_Item_Tusked_Bracers"	"Tusked Bracers"
"[english]DOTA_Item_Tusked_Bracers"	"Tusked Bracers"
"DOTA_Item_Desc_Tusked_Bracers"	"Nature's Prophet のことを花や木の使いだと考える物が大勢いる。彼らは森の熊が持つ凶暴な爪や猪の猛烈な牙を忘れている。"
"[english]DOTA_Item_Desc_Tusked_Bracers"	"Many would think the Nature's Prophet a thing of leaf and flower. They forget the rending claws of the forest bear and the tearing tusks of the deep woods boars."
"DOTA_Item_Desc_Taunt_Kata_of_Foot_and_Earth"	"武術の腕前を形で実演。"
"[english]DOTA_Item_Desc_Taunt_Kata_of_Foot_and_Earth"	"Demonstrate your martial skill with this kata."
"DOTA_Item_Stoic_Mask_of_the_High_Plains"	"Stoic Mask of the High Plains"
"[english]DOTA_Item_Stoic_Mask_of_the_High_Plains"	"Stoic Mask of the High Plains"
"DOTA_Item_Desc_Aspect_Wraps_of_the_High_Plains"	"強力な山の狼より製造された実用的な籠手のセット。"
"[english]DOTA_Item_Desc_Aspect_Wraps_of_the_High_Plains"	"A set of serviceable bracers, made from the mighty mountain wolf."
"DOTA_Item_Desc_Taunt_Kata_of_Blade_and_Sky"	"その攻撃は死をもたらす単なるツールではなく、価値を表現するためのものだ。"
"[english]DOTA_Item_Desc_Taunt_Kata_of_Blade_and_Sky"	"The strike is not merely a tool to bring death. It is an expression of worth."
"DOTA_Item_Octopus_Hat"	"Octopus Hat"
"[english]DOTA_Item_Octopus_Hat"	"Octopus Hat"
"DOTA_Item_Desc_Octopus_Hat"	"ヒッチハイク気取りなのか？Tidehunter の頭と交尾する気なのか？Tidehunter の思考に影響を与えられるとでも考えているのか？答えは誰も知らない。"
"[english]DOTA_Item_Desc_Octopus_Hat"	"Is it trying to hitch a ride?  Is it trying to mate with his head?  Does it think it can influence the Tidehunter's thoughts?  Who knows!"
"DOTA_Item_Wyrm_Shield_of_Uldorak"	"Wyrm Shield of Uldorak"
"[english]DOTA_Item_Wyrm_Shield_of_Uldorak"	"Wyrm Shield of Uldorak"
"DOTA_Item_Desc_Wyrm_Shield_of_Uldorak"	"時のドラゴン Uldorak と戦って討った日、Dragon Knight は このシールドを持っていた。"
"[english]DOTA_Item_Desc_Wyrm_Shield_of_Uldorak"	"The Dragon Knight bore this shield the day he fought and slew the Time Dragon Uldorak."
"DOTA_Item_Belt_o_Wicked_Badness"	"Belt o' Wicked Badness"
"[english]DOTA_Item_Belt_o_Wicked_Badness"	"Belt o' Wicked Badness"
"DOTA_Item_Desc_Belt_o_Wicked_Badness"	"Witch Doctor の部族の祖先の頭蓋骨で装飾されたベルト。"
"[english]DOTA_Item_Desc_Belt_o_Wicked_Badness"	"The skulls of the Witch Doctor's tribal ancestors adorn this belt."
"DOTA_Item_Kimono_of_the_Ebony_Tower"	"漆黒の塔の着物"
"[english]DOTA_Item_Kimono_of_the_Ebony_Tower"	"Kimono of the Ebony Tower"
"DOTA_Item_Desc_Kimono_of_the_Ebony_Tower"	"象牙と黒壇の間に立つ偉大な戦士は剣で助けてくれるが、その心や精神を見せることはない。"
"[english]DOTA_Item_Desc_Kimono_of_the_Ebony_Tower"	"The greatest warrior stands between Ivory and Ebony, lending sword and hand but not heart or mind."
"DOTA_Item_Bracers_of_the_Ebony_Tower"	"Bracers of the Ebony Tower"
"[english]DOTA_Item_Bracers_of_the_Ebony_Tower"	"Bracers of the Ebony Tower"
"DOTA_Item_Desc_Bracers_of_the_Ebony_Tower"	"飾りたてられた支配者は他の意思を捻じ曲げる。"
"[english]DOTA_Item_Desc_Bracers_of_the_Ebony_Tower"	"A lord so adorned will bend the will of many."
"DOTA_Item_Relic_Blade_of_the_KuurIshiminari"	"Relic Blade of the Kuur-Ishiminari"
"[english]DOTA_Item_Relic_Blade_of_the_KuurIshiminari"	"Relic Blade of the Kuur-Ishiminari"
"DOTA_Item_Fine_Bone_Bracers"	"Fine Bone Bracers"
"[english]DOTA_Item_Fine_Bone_Bracers"	"Fine Bone Bracers"
"DOTA_Item_Desc_Fine_Bone_Bracers"	"異質な獣の骨から製造された籠手"
"[english]DOTA_Item_Desc_Fine_Bone_Bracers"	"Bracers crafted from the fine bone of some alien beast."
"DOTA_Item_PreyTrackers_Aspect_Mask"	"Prey-Tracker's Aspect Mask"
"[english]DOTA_Item_PreyTrackers_Aspect_Mask"	"Prey-Tracker's Aspect Mask"
"DOTA_Item_Desc_100Proof_Mask"	"Juggernaut は多くの偉大な悪魔や蛮族と直面してきた。 そのうちのいくつかは異質な知性を用いて狩りを行った。彼は、その時の彼らの狡猾さや恐怖の側面を保存するためにこのマスクを制作した。"
"[english]DOTA_Item_Desc_100Proof_Mask"	"Juggernaut has faced many great demons and abominations. A few of these hunt with an alien intellect. He has crafted this mask to capture some aspect of their cunning and horror."
"DOTA_Item_Desc_Wyrm_Helm_of_Uldorak"	"Eldwurm と運命的な遭遇を果たす何年も前に、Dragon Knight は時のドラゴン Uldorak との戦いに勝利した。 戴冠したばかりの王Tansis 13世は安心し、褒美としてこの兜を鍛造させた。"
"[english]DOTA_Item_Desc_Wyrm_Helm_of_Uldorak"	"Many years before his fateful encounter with the Eldwurm, the Dragon Knight battled with and slew the Time-Dragon Uldorak. The much relieved and newly crowned King Tansis XIII ordered this helm forged as a gift and reward."
"DOTA_Item_Wyrm_Skirt_of_Uldorak"	"Wyrm Skirt of Uldorak"
"[english]DOTA_Item_Wyrm_Skirt_of_Uldorak"	"Wyrm Skirt of Uldorak"
"DOTA_Item_Desc_Naval_Mine"	"海深くに投げ落とされ、Tidehunter お気に入りの珊瑚のベッドを破壊したとき、彼はその持ち主を必ず探し出すことを決意した。"
"[english]DOTA_Item_Desc_Naval_Mine"	"When it fell to the depths and smashed a favorite coral bed, the Tidehunter swore to reunite the device with its owner."
"DOTA_Item_Desc_Swamp_Fins"	"怒りを表すのか、それとも発情期を示すのか、このヒレの意味を知るものは誰も居ない。訊ねようにも生き延びた者もいない。"
"[english]DOTA_Item_Desc_Swamp_Fins"	"Nobody is certain whether this display means the Tidehunter is angry or in heat.  Either way, none have survived to ask."
"DOTA_Item_Bracers_of_the_Radiant_Crusader"	"Bracers of the Radiant Crusader"
"[english]DOTA_Item_Bracers_of_the_Radiant_Crusader"	"Bracers of the Radiant Crusader"
"DOTA_Item_Desc_Bracers_of_the_Radiant_Crusader"	"まるでその武器が発明されたばかりであるかのように極めて原始的ではあるが、彼らが戦闘を見たことがない等と思い込んではいけない。"
"[english]DOTA_Item_Desc_Bracers_of_the_Radiant_Crusader"	"They are as pristine as the day they were made, but do not be fooled into thinking they have never seen combat."
"DOTA_Item_Mask_of_the_Freelancer"	"Mask of the Freelancer"
"[english]DOTA_Item_Mask_of_the_Freelancer"	"Mask of the Freelancer"
"DOTA_Item_Desc_Mask_of_the_Freelancer"	"この古い剣闘士の兜は名誉と金を求めてさ迷う道中で Sven の役に立っている。"
"[english]DOTA_Item_Desc_Mask_of_the_Freelancer"	"This old gladiatorial helm serves Sven well as he travels the land in search of honor and gold."
"DOTA_Item_Shoulderguard_of_the_Freelancer"	"Shoulderguard of the Freelancer"
"[english]DOTA_Item_Shoulderguard_of_the_Freelancer"	"Shoulderguard of the Freelancer"
"DOTA_Item_Desc_Shoulderguard_of_the_Freelancer"	"放浪の剣士は保護の必要性とスピードの必要性のバランスを見極めなければならない。この肩甲は腕の裏側を邪魔すること無く、Sven の一流の肩を保護する。"
"[english]DOTA_Item_Desc_Shoulderguard_of_the_Freelancer"	"Rogue swordmasters must balance the need for protection with the need for speed. This pauldron protects Sven's leading shoulder, but leaves his back arm unencumbered."
"DOTA_Item_Pantaloons_of_the_Freelancer"	"Pantaloons of the Freelancer"
"[english]DOTA_Item_Pantaloons_of_the_Freelancer"	"Pantaloons of the Freelancer"
"DOTA_Item_Desc_Pantaloons_of_the_Freelancer"	"旅が栄誉と同様にSven に金をもたらしてきたことがこの素晴らしいズボンから伺える。"
"[english]DOTA_Item_Desc_Pantaloons_of_the_Freelancer"	"These fine pantaloons show that Sven's travels have led him into gold as much as glory."
"DOTA_Item_Sword_of_the_Freelancer"	"Sword of the Freelancer"
"[english]DOTA_Item_Sword_of_the_Freelancer"	"Sword of the Freelancer"
"DOTA_Item_Dragonmaw"	"Dragonmaw"
"[english]DOTA_Item_Dragonmaw"	"Dragonmaw"
"DOTA_Item_Desc_Dragonmaw"	"Dragonmaw は名のある数々の剣と比べても強力だ。そのギザギザとした刃は最強の獣の皮を切り裂き、その下の無防備な肉を露呈させる。"
"[english]DOTA_Item_Desc_Dragonmaw"	"Dragonmaw is mighty even among the Named Swords. It's jagged teeth rip at even the strongest hides, laying bear the vulnerable flesh beneath."
"DOTA_Item_Pirate_Slayers_Bracer"	"Pirate Slayer の籠手"
"[english]DOTA_Item_Pirate_Slayers_Bracer"	"Pirate Slayer's Bracer"
"DOTA_Item_Executioners_Cape"	"Executioner の肩マント"
"[english]DOTA_Item_Executioners_Cape"	"Executioner's Cape"
"DOTA_Item_SeaGods_Ceremonial_Headdress"	"Sea-God の儀式用の頭飾り"
"[english]DOTA_Item_SeaGods_Ceremonial_Headdress"	"Sea-God's Ceremonial Headdress"
"DOTA_Item_Desc_SeaGods_Ceremonial_Headdress"	"この新しいアイテムには説明がありません。"
"[english]DOTA_Item_Desc_SeaGods_Ceremonial_Headdress"	"This new item has no description."
"DOTA_Item_Forgemasters_Mask"	"Forgemaster のマスク"
"[english]DOTA_Item_Forgemasters_Mask"	"Forgemaster's Mask"
"DOTA_Item_Chronite_Bracers"	"Chronite Bracers"
"[english]DOTA_Item_Chronite_Bracers"	"Chronite Bracers"
"DOTA_Item_Desc_Chronite_Bracers"	"敵からの未来の攻撃を Faceless Void に警告するらしい Ｃｈｒｏｎｉｔｅ がちりばめられた籠手。"
"[english]DOTA_Item_Desc_Chronite_Bracers"	"A pair of chronite encrusted bracers that seem to warn the Faceless Void of his enemies' future attacks."
"DOTA_Item_Ice_Burst_Bracers"	"Ice Burst Bracers"
"[english]DOTA_Item_Ice_Burst_Bracers"	"Ice Burst Bracers"
"DOTA_Item_Desc_Ice_Burst_Bracers"	"その大きさの割りに、これらの鋭利な氷の結晶にはほとんど重量が無いため、 Drow Ranger の弓の使用を邪魔することがない。"
"[english]DOTA_Item_Desc_Ice_Burst_Bracers"	"Despite their size, these sharp ice-like crystals weigh almost nothing and so do not hinder the Drow Ranger's use of the bow."
"DOTA_Item_Desc_Pirate_Slayers_Black_Flag"	"かつては恐怖の象徴であったが、今はTidehunter の力の象徴である。"
"[english]DOTA_Item_Desc_Pirate_Slayers_Black_Flag"	"The remains of a once terrible icon, now a symbol of the Tidehunter's power."
"DOTA_Item_ShovelMouthed_Mask"	"Shovel-Mouthed Mask"
"[english]DOTA_Item_ShovelMouthed_Mask"	"Shovel-Mouthed Mask"
"DOTA_Item_Commanders_Helm_of_the_Flameguard"	"Commander's Helm of the Flameguard"
"[english]DOTA_Item_Commanders_Helm_of_the_Flameguard"	"Commander's Helm of the Flameguard"
"DOTA_Item_Lucky_Alpine_Stalkers_Hat"	"Lucky Alpine Stalker の帽子"
"[english]DOTA_Item_Lucky_Alpine_Stalkers_Hat"	"Lucky Alpine Stalker's Hat"
"DOTA_Item_Alpine_Stalkers_Scarf"	"Alpine Stalker のスカーフ"
"[english]DOTA_Item_Alpine_Stalkers_Scarf"	"Alpine Stalker's Scarf"
"DOTA_Item_Alpine_Stalkers_Pants"	"Alpine Stalker のズボン"
"[english]DOTA_Item_Alpine_Stalkers_Pants"	"Alpine Stalker's Pants"
"DOTA_Item_Alpine_Stalkers_Gloves"	"Alpine Stalker の手袋"
"[english]DOTA_Item_Alpine_Stalkers_Gloves"	"Alpine Stalker's Gloves"
"DOTA_Item_Desc_Witch_Doctors_Vile_Hat"	"この新しいアイテムには説明がありません。"
"[english]DOTA_Item_Desc_Witch_Doctors_Vile_Hat"	"This new item has no description."
"DOTA_Item_Mask_o_Wicked_Badness"	"Mask o' Wicked Badness"
"[english]DOTA_Item_Mask_o_Wicked_Badness"	"Mask o' Wicked Badness"
"DOTA_Item_Witch_Doctors_Wooden_Mask"	"Witch Doctor's Wooden Mask"
"[english]DOTA_Item_Witch_Doctors_Wooden_Mask"	"Witch Doctor's Wooden Mask"
"DOTA_Item_Wich_Doctors_Tribal_Mask"	"Witch Doctor's Tribal Mask"
"[english]DOTA_Item_Wich_Doctors_Tribal_Mask"	"Witch Doctor's Tribal Mask"
"DOTA_Item_Desc_Cape_of_the_Burning_Cabal"	"Burning Cabal の行使者は他の分野よりも Exort を好む。"
"[english]DOTA_Item_Desc_Cape_of_the_Burning_Cabal"	"The invokers of the Burning Cabal favor Exort over all other disciplines."
"DOTA_Item_Desc_Crest_of_the_Burning_Cabal"	"Burning Cabal の紋章。これは炎の使い手であることを示す。"
"[english]DOTA_Item_Desc_Crest_of_the_Burning_Cabal"	"The war-crest of the Burning Cabal. This identifies the invoker as a specialist in fire manipulation."
"DOTA_Item_Desc_Stylish_Wizards_Topnot"	"スタイリッシュだと思われている魔法使いの数は多くは無いが、Invoker は他の魔法使いとは違う。"
"[english]DOTA_Item_Desc_Stylish_Wizards_Topnot"	"Few wizards can be considered to be stylish, but the Invoker is not like other wizards."
"DOTA_Item_Commanders_Skirt_of_the_Flameguard"	"Commander's Skirt of the Flameguard"
"[english]DOTA_Item_Commanders_Skirt_of_the_Flameguard"	"Commander's Skirt of the Flameguard"
"DOTA_Trial_UpgradeItem"	"Dota 2 アップグレードアイテムトライアル"
"[english]DOTA_Trial_UpgradeItem"	"Dota 2 Trial Upgrade Item"
"DOTA_Item_Fearless_Badger"	"Fearless Badger"
"[english]DOTA_Item_Fearless_Badger"	"Fearless Badger"
"DOTA_Item_Desc_Badger_Courier"	"Badger は、森に住む生き物の中でおそらく最高のクーリエであろう。恐れを知らず、素早いだけでなく、信頼を勝ち得た者のみに服従する。"
"[english]DOTA_Item_Desc_Badger_Courier"	"Of all the creatures of the forest, the badger makes perhaps the finest courier. Fearless and quick, it bends its will to none save those who have earned its trust."
"DOTA_Item_Desc_Treasure_Chest"	"この宝箱を開けるには <font color='#9da1a9'>宝箱の鍵</font> が必要です。DOTA 2 ストアで入手可能です。各宝箱シリーズはさまざまな種類のお宝が入っています。"
"[english]DOTA_Item_Desc_Treasure_Chest"	"You will need a <font color='#9da1a9'>Treasure Key</font> to open this chest. You can pick one up at the DOTA 2 Store. Each chest series comes with a different selection of possible loot."
"DOTA_Item_Name_Tag"	"ネームタグ"
"[english]DOTA_Item_Name_Tag"	"Name Tag"
"DOTA_Item_Desc_Tag"	"説明タグ"
"[english]DOTA_Item_Desc_Tag"	"Description Tag"
"DOTA_Item_Treasure_Key"	"宝箱の鍵"
"[english]DOTA_Item_Treasure_Key"	"Treasure Key"
"DOTA_Item_Desc_Gift_RandomPerson"	"使用すると、このアクションアイテムは<font color='#9da1a9'>ランダムアイテムドロップを</font> サーバー内の（あなた以外の）<font color='#9da1a9'>プレイヤーに</font> 付与します。このアイテムをアクションアイテムとして装備し、マッチの最中に有効化しましょう。"
"[english]DOTA_Item_Desc_Gift_RandomPerson"	"When used, this Action Item gives a <font color='#9da1a9'>random item drop</font> to a <font color='#9da1a9'>random person</font> on the server (not you). You can use this item by equipping it as an action item and then activating it during a match."
"DOTA_Item_Desc_Gift_EntireGame"	"使用すると、このアクションアイテムは <font color='#9da1a9'>ランダムアイテムドロップ</font>をサーバー内の（あなたを除く） <font color='#9da1a9'>9 人のランダムなプレイヤーと観戦者</font>に付与します。このアイテムをアクションアイテムとして装備し、マッチの最中に有効化しましょう。"
"[english]DOTA_Item_Desc_Gift_EntireGame"	"When used, this Action Item gives a <font color='#9da1a9'>random item drop</font> to up to <font color='#9da1a9'>9 random players and spectators</font> on the server (except you). You can use this item by equipping it as an action item and then activating it during a match."
"DOTA_Item_Desc_Gift_Tons"	"使用すると、このアクションアイテムは<font color='#9da1a9'>ランダムアイテムドロップ</font>をサーバー上の（あなたを除く）最高で<font color='#9da1a9'>25人のプレイヤーと観戦者</font>に付与します。 このアイテムをアクションアイテムとして装備し、マッチの最中に有効化しましょう。"
"[english]DOTA_Item_Desc_Gift_Tons"	"When used, this Action Item gives a <font color='#9da1a9'>random item drop</font> to up to <font color='#9da1a9'>25 random players and spectators</font> on the server (except you). You can use this item by equipping it as an action item and then activating it during a match."
"DOTA_Item_Desc_Wicked_Bad_Voodoo_Pack"	"上手なサポートプレイヤーはみんなの人気者。優れたプレイスタイルを応援するために、<font color='#9da1a9'>無料の</font> ギフトを DOTA 2 ストアからあげることができます！インベントリからこのパックをダブルクリックかまたは右クリックすると、Witch Doctorのための特別なアイテムコレクションが出てきます。このパックには<font color='#9da1a9'>Wicked Bad Voodoo</font>セットに含まれる3アイテムが入っています: 新しい仮面、杖、背負うタイプのアイテム。"
"[english]DOTA_Item_Desc_Wicked_Bad_Voodoo_Pack"	"Everyone loves a good support player and now you can provide support in wicked style with this  <font color='#9da1a9'>free</font> gift from the DOTA 2 store!<br><br>Double-click or right-click this pack from your inventory to unpack a special collection of items for the Witch Doctor.<br><br>This pack includes 3 items in the <font color='#9da1a9'>Wicked Bad Voodoo</font> set: a new mask, a new staff, and a new back item."
"DOTA_Item_Of_Ebony_and_Ivory_Set"	"Of Ebony and Ivory セット"
"[english]DOTA_Item_Of_Ebony_and_Ivory_Set"	"Of Ebony and Ivory Set"
"DOTA_Bundle_Desc_Juggernaut_Ivory_Ebony"	"Juggernaut 用の'Of Ebony and Ivory' セットに含まれる全てのアイテム:"
"[english]DOTA_Bundle_Desc_Juggernaut_Ivory_Ebony"	"Includes all of the items in the 'Of Ebony and Ivory' set for Juggernaut:"
"DOTA_Bundle_Desc_Witch_Doctor_Wicked_Bad_Voodoo"	"Witch Doctor 用の'Wicked Bad Voodoo' セットに含まれる全てのアイテム:"
"[english]DOTA_Bundle_Desc_Witch_Doctor_Wicked_Bad_Voodoo"	"Includes all of the items in the 'Wicked Bad Voodoo' set for Witch Doctor:"
"DOTA_Item_Forged_in_Demons_Blood_Set"	"Forged in Demons' Blood セット"
"[english]DOTA_Item_Forged_in_Demons_Blood_Set"	"Forged in Demons' Blood Set"
"DOTA_Bundle_Desc_Axe_Demon_Blood"	"Axe 用の'Forged in Demons Blood' セットに含まれる全てのアイテム:"
"[english]DOTA_Bundle_Desc_Axe_Demon_Blood"	"Includes all of the items in the 'Forged in Demons Blood' set for Axe:"
"DOTA_Bundle_Desc_Axe_Defiant"	"Axe 用の'Defiant Axe' セットに含まれる全てのアイテム:"
"[english]DOTA_Bundle_Desc_Axe_Defiant"	"Includes all of the items in the 'Defiant Axe' set for Axe:"
"DOTA_Bundle_Desc_Natures_Prophet_Forest_Lord"	"Nature's Prophet 用の'Regal Forest Lord' セットに含まれる全てのアイテム:"
"[english]DOTA_Bundle_Desc_Natures_Prophet_Forest_Lord"	"Includes all of the items in the 'Regal Forest Lord' set for Nature's Prophet:"
"DOTA_Bundle_Desc_Juggernaut_Boar_God"	"Juggernaut 用の'The Boar God's Honor' セットに含まれる全てのアイテム:"
"[english]DOTA_Bundle_Desc_Juggernaut_Boar_God"	"Includes all of the items in the 'The Boar God's Honor' set for Juggernaut:"
"DOTA_Item_Aspects_of_Beast_and_Man_Set"	"Aspects of Beast and Man セット"
"[english]DOTA_Item_Aspects_of_Beast_and_Man_Set"	"Aspects of Beast and Man Set"
"DOTA_Bundle_Desc_Juggernaut_Beasts_Man"	"Juggernaut 用の'Aspects of Beast and Man' セットに含まれる全てのアイテム:"
"[english]DOTA_Bundle_Desc_Juggernaut_Beasts_Man"	"Includes all of the items in the 'Aspects of Beast and Man' set for Juggernaut:"
"DOTA_Bundle_Desc_Juggernaut_High_Plains"	"Juggernaut 用の'Traveler on the High Plains' セットに含まれる全てのアイテム:"
"[english]DOTA_Bundle_Desc_Juggernaut_High_Plains"	"Includes all of the items in the 'Traveler on the High Plains' set for Juggernaut:"
"DOTA_Item_Scion_of_the_Savage_Set"	"Scion of the Savage セット"
"[english]DOTA_Item_Scion_of_the_Savage_Set"	"Scion of the Savage Set"
"DOTA_Bundle_Desc_Natures_Prophet_Scion_Savage"	"Nature's Prophet 用の'Scion of the Savage' セットに含まれる全てのアイテム:"
"[english]DOTA_Bundle_Desc_Natures_Prophet_Scion_Savage"	"Includes all of the items in the 'Scion of the Savage' set for Nature's Prophet:"
"DOTA_Bundle_Natures_Prophet_Heartwood_Vanguard"	"Heartwood Vanguard セット"
"[english]DOTA_Bundle_Natures_Prophet_Heartwood_Vanguard"	"Heartwood Vanguard Set"
"DOTA_Bundle_Desc_Natures_Prophet_Heartwood_Vanguard"	"Nature's Prophet 用の'Heartwood Vanguard' セットに含まれる全てのアイテム:"
"[english]DOTA_Bundle_Desc_Natures_Prophet_Heartwood_Vanguard"	"Includes all of the items in the 'Heartwood Vanguard' set for Nature's Prophet:"
"DOTA_Bundle_Desc_Natures_Prophet_Peace_Bringer"	"Nature's Prophet 用の'Garments of the Peace-Bringer' セットに含まれる全てのアイテム:"
"[english]DOTA_Bundle_Desc_Natures_Prophet_Peace_Bringer"	"Includes all of the items in the 'Garments of the Peace-Bringer' set for Nature's Prophet:"
"DOTA_Bundle_Desc_Natures_Prophet_Beast_Bole"	"Nature's Prophet 用の'Master of Beast and Bole' セットに含まれる全てのアイテム:"
"[english]DOTA_Bundle_Desc_Natures_Prophet_Beast_Bole"	"Includes all of the items in the 'Master of Beast and Bole' set for Nature's Prophet:"
"DOTA_Bundle_Axe_Berserker"	"Berserker's Blood セット"
"[english]DOTA_Bundle_Axe_Berserker"	"The Berserker's Blood Set"
"DOTA_Bundle_Desc_Axe_Berserker"	"Axe 用の'The Berserker's Blood' セットに含まれる全てのアイテム:"
"[english]DOTA_Bundle_Desc_Axe_Berserker"	"Includes all of the items in the 'The Berserker's Blood' set for Axe:"
"DOTA_Bundle_Axe_Forgemaster"	"Forgemaster's Tools セット"
"[english]DOTA_Bundle_Axe_Forgemaster"	"The Forgemaster's Tools Set"
"DOTA_Bundle_Desc_Axe_Forgemaster"	"Axe 用の'The Forgemaster's Tools' セットに含まれる全てのアイテム:"
"[english]DOTA_Bundle_Desc_Axe_Forgemaster"	"Includes all of the items in the 'The Forgemaster's Tools' set for Axe:"
"DOTA_Bundle_Axe_Axecutioner"	"Axecutioner セット"
"[english]DOTA_Bundle_Axe_Axecutioner"	"The Axecutioner Set"
"DOTA_Bundle_Desc_Axe_Axecutioner"	"Axe 用の'The Axecutioner' セットに含まれる全てのアイテム:"
"[english]DOTA_Bundle_Desc_Axe_Axecutioner"	"Includes all of the items in the 'The Axecutioner' set for Axe:"
"DOTA_Bundle_Sven_Swordmaster"	"Swordmaster of the Vigil Set"
"[english]DOTA_Bundle_Sven_Swordmaster"	"Swordmaster of the Vigil Set"
"DOTA_Bundle_Desc_Sven_Swordmaster"	"Sven 用の'Swordmaster of the Vigil' セットに含まれる全てのアイテム:"
"[english]DOTA_Bundle_Desc_Sven_Swordmaster"	"Includes all of the items in the 'Swordmaster of the Vigil' set for Sven:"
"DOTA_Bundle_Sven_Freelancer"	"The Freelancer's Finery Set"
"[english]DOTA_Bundle_Sven_Freelancer"	"The Freelancer's Finery Set"
"DOTA_Bundle_Desc_Sven_Freelancer"	"Sven 用の'The Freelancer's Finery' セットに含まれる全てのアイテム:"
"[english]DOTA_Bundle_Desc_Sven_Freelancer"	"Includes all of the items in the 'The Freelancer's Finery' set for Sven:"
"DOTA_Bundle_Sven_Mono_Militis"	"Mono Militis Set"
"[english]DOTA_Bundle_Sven_Mono_Militis"	"Mono Militis Set"
"DOTA_Bundle_Desc_Sven_Mono_Militis"	"Sven 用の'Sect Armor of the Mono Militis' セットに含まれる全てのアイテム:"
"[english]DOTA_Bundle_Desc_Sven_Mono_Militis"	"Includes all of the items in the 'Sect Armor of the Mono Militis' set for Sven:"
"DOTA_Bundle_Sven_Flameguard"	"Flameguard Set"
"[english]DOTA_Bundle_Sven_Flameguard"	"Flameguard Set"
"DOTA_Bundle_Desc_Sven_Flameguard"	"Sven 用の'Sect Armor of the Flameguard' セットに含まれる全てのアイテム:"
"[english]DOTA_Bundle_Desc_Sven_Flameguard"	"Includes all of the items in the 'Sect Armor of the Flameguard' set for Sven:"
"DOTA_Item_Chronite_Defense_Set"	"Chronite Defense セット"
"[english]DOTA_Item_Chronite_Defense_Set"	"Chronite Defense Set"
"DOTA_Item_Direstone_Bindings_Set"	"Direstone Bindings セット"
"[english]DOTA_Item_Direstone_Bindings_Set"	"Direstone Bindings Set"
"DOTA_Item_Desc_Direstone_Bindings_Set"	"Sven 用の'Direstone Bindings' セットに含まれる全てのアイテム:"
"[english]DOTA_Item_Desc_Direstone_Bindings_Set"	"Includes all of the items in the 'Direstone Bindings' set for Morphling:"
"DOTA_Item_Ritual_Garb_of_the_Seeker_Set"	"Ritual Garb of the Seeker セット"
"[english]DOTA_Item_Ritual_Garb_of_the_Seeker_Set"	"Ritual Garb of the Seeker Set"
"DOTA_Bundle_Desc_Blood_Seeker_Hlotl"	"Bloodseeker 用の'Ritual Garb of the Seeker' セットに含まれる全てのアイテム:"
"[english]DOTA_Bundle_Desc_Blood_Seeker_Hlotl"	"Includes all of the items in the 'Ritual Garb of the Seeker' set for Bloodseeker:"
"DOTA_Bundle_Desc_Tidehunter_Pirate_Slayer"	"Tidehunter 用の'The Pirate's Booty' セットに含まれる全てのアイテム:"
"[english]DOTA_Bundle_Desc_Tidehunter_Pirate_Slayer"	"Includes all of the items in the 'The Pirate's Booty' set for Tidehunter:"
"DOTA_Bundle_Desc_Tidehunter_Punisher"	"Tidehunter 用の'The Paleogeneous Punisher' セットに含まれる全てのアイテム:"
"[english]DOTA_Bundle_Desc_Tidehunter_Punisher"	"Includes all of the items in the 'The Paleogeneous Punisher' set for Tidehunter:"
"DOTA_Item_The_Admirable_Admiral_Set"	"The Admirable Admiral セット"
"[english]DOTA_Item_The_Admirable_Admiral_Set"	"The Admirable Admiral Set"
"DOTA_Bundle_Desc_Kunkka_Admirable_Admiral"	"Kunkka 用の'The Admirable Admiral' セットに含まれる全てのアイテム:"
"[english]DOTA_Bundle_Desc_Kunkka_Admirable_Admiral"	"Includes all of the items in the 'The Admirable Admiral' set for Kunkka:"
"DOTA_Bundle_Desc_Dragon_Knight_Uldorak"	"Dragon Knight 用の'Uldorak's Hide' セットに含まれる全てのアイテム:"
"[english]DOTA_Bundle_Desc_Dragon_Knight_Uldorak"	"Includes all of the items in the 'Uldorak's Hide' set for Dragon Knight:"
"DOTA_Bundle_Desc_Omniknight_Crusader"	"Omniknight 用の'The Radiance of the Crusade' セットに含まれる全てのアイテム:"
"[english]DOTA_Bundle_Desc_Omniknight_Crusader"	"Includes all of the items in the 'The Radiance of the Crusade' set for Omniknight:"
"DOTA_Bundle_Desc_Invoker_Exort"	"Invoker 用の'The Fires of Exort' セットに含まれる全てのアイテム:"
"[english]DOTA_Bundle_Desc_Invoker_Exort"	"Includes all of the items in the 'The Fires of Exort' set for Invoker:"
"DOTA_Bundle_DOTA2_Access"	"Dota 2 招待"
"[english]DOTA_Bundle_DOTA2_Access"	"Dota 2 Invite"
"DOTA_Bundle_Desc_DOTA2_Access"	"今すぐ Dota 2 へアクセスしてプレイ開始しましょう！このバンドルには Mighty Boar courier、Sven Juggernaut と Witch Doctor 用のアイテム一式が含まれます。現在 Dota 2 はPC のみでプレイ可能です。"
"[english]DOTA_Bundle_Desc_DOTA2_Access"	"Get immediate access to Dota 2 and start playing right away!
			This bundle includes a Mighty Boar courier, and a full set of items for Sven, Juggernaut, and Witch Doctor. Dota 2 is currently only available on the PC."
"DOTA_Item_Spikes_of_Frost_Set"	"Spikes of Frost セット"
"[english]DOTA_Item_Spikes_of_Frost_Set"	"Spikes of Frost Set"
"DOTA_Bundle_Desc_Drow_Ranger_Spikes_Frost"	"Drow Ranger 用の'Spikes of Frost' セットに含まれる全てのアイテム:"
"[english]DOTA_Bundle_Desc_Drow_Ranger_Spikes_Frost"	"Includes all of the items in the 'Spikes of Frost' set for Drow Ranger:"
"DOTA_Bundle_Desc_Bounty_Hunter_Pangolin"	"Bounty Hunter 用の'Trappings of the Pangolin Guild' セットに含まれる全てのアイテム:"
"[english]DOTA_Bundle_Desc_Bounty_Hunter_Pangolin"	"Includes all of the items in the 'Trappings of the Pangolin Guild' set for Bounty Hunter:"
"DOTA_Item_Desc_WildCardsWest"	"Th International への参加をかけて競う最高の8チームを見る"
"[english]DOTA_Item_Desc_WildCardsWest"	"Watch eight of the best Dota 2 teams compete for a spot in The International"
"DOTA_Item_Desc_WildCardsEast"	"Th International への参加をかけて競う最高の8チームを見る"
"[english]DOTA_Item_Desc_WildCardsEast"	"Watch eight of the best Dota 2 teams compete for a spot in The International"
"DOTA_WearableType_Shoulder_Pads"	"肩当て"
"[english]DOTA_WearableType_Shoulder_Pads"	"Shoulder Pads"
"DOTA_WearableType_Strange_Modifier"	"ストレンジモディファイア"
"[english]DOTA_WearableType_Strange_Modifier"	"Strange Modifier"
"DOTA_Item_Phantom_Assassins_Helmet"	"Phantom Assassin の兜"
"[english]DOTA_Item_Phantom_Assassins_Helmet"	"Phantom Assassin's Helmet"
"DOTA_Item_Desc_Phantom_Assassins_Helmet"	"この新しいアイテムには説明がありません。"
"[english]DOTA_Item_Desc_Phantom_Assassins_Helmet"	"This new item has no description."
"DOTA_Item_Phantom_Assassins_Shoulder_Pads"	"Phantom Assassin の肩当て"
"[english]DOTA_Item_Phantom_Assassins_Shoulder_Pads"	"Phantom Assassin's Shoulder Pads"
"DOTA_Item_Desc_Copy_of_Phantom_Assassins_Helmet"	"この新しいアイテムには説明がありません。"
"[english]DOTA_Item_Desc_Copy_of_Phantom_Assassins_Helmet"	"This new item has no description."
"DOTA_Item_Phantom_Assassins_Cape"	"Phantom Assassin の肩マント"
"[english]DOTA_Item_Phantom_Assassins_Cape"	"Phantom Assassin's Cape"
"DOTA_Item_Desc_Copy_of_Phantom_Assassins_Shoulder_Pads"	"この新しいアイテムには説明がありません。"
"[english]DOTA_Item_Desc_Copy_of_Phantom_Assassins_Shoulder_Pads"	"This new item has no description."
"DOTA_Item_Phantom_Assassins_Weapon"	"Phantom Assassin の武器"
"[english]DOTA_Item_Phantom_Assassins_Weapon"	"Phantom Assassin's Weapon"
"DOTA_Item_Desc_Copy_of_Phantom_Assassins_Cape"	"この新しいアイテムには説明がありません。"
"[english]DOTA_Item_Desc_Copy_of_Phantom_Assassins_Cape"	"This new item has no description."
"DOTA_Item_Desc_Phantom_Assassins_Daggers"	"この新しいアイテムには説明がありません。"
"[english]DOTA_Item_Desc_Phantom_Assassins_Daggers"	"This new item has no description."
"DOTA_Item_Horn_Mask"	"Horn Mask"
"[english]DOTA_Item_Horn_Mask"	"Horn Mask"
"DOTA_Item_Ol_Snaggletooth"	"Ol' Snaggletooth"
"[english]DOTA_Item_Ol_Snaggletooth"	"Ol' Snaggletooth"
"DOTA_Item_Wooden_Fetish_Mask"	"Wooden Fetish Mask"
"[english]DOTA_Item_Wooden_Fetish_Mask"	"Wooden Fetish Mask"
"DOTA_Item_Tribal_Totem_Mask"	"Tribal Totem Mask"
"[english]DOTA_Item_Tribal_Totem_Mask"	"Tribal Totem Mask"
"DOTA_Item_Strange_Modifier_Godlikes"	"ストレンジモディファイア：ゴッドライク"
"[english]DOTA_Item_Strange_Modifier_Godlikes"	"Strange Modifier: Godlike"
"DOTA_Item_Desc_Strange_Modifier_Godlikes"	"選択したストレンジアイテムにこのストレンジモディファイアを追加することによって、着用している間に獲得した連続ゴッドライクの数がカウントされます。"
"[english]DOTA_Item_Desc_Strange_Modifier_Godlikes"	"Adding this Strange Modifier to a strange item of your choice will allow it to also track the number of godlike killing sprees you obtain while wearing it."
"DOTA_Item_Strange_Modifier_First_Blood"	"ストレンジモディファイア：ファーストブラッド"
"[english]DOTA_Item_Strange_Modifier_First_Blood"	"Strange Modifier: First Blood"
"DOTA_Item_Desc_Strange_Modifier_First_Blood"	"選択したストレンジアイテムにこのストレンジモディファイアを追加することによって、着用している間に獲得したファーストブラッドの数がカウントされます。"
"[english]DOTA_Item_Desc_Strange_Modifier_First_Blood"	"Adding this Strange Modifier to a strange item of your choice will allow it to also track the number of first bloods you obtain while wearing it."
"DOTA_Item_Strange_Modifier_Wards_Placed"	"ストレンジモディファイア：ワード設置"
"[english]DOTA_Item_Strange_Modifier_Wards_Placed"	"Strange Modifier: Wards Placed"
"DOTA_Item_Desc_Strange_Modifier_Wards_Placed"	"選択したストレンジアイテムにこのストレンジモディファイアを追加することによって、着用している間に設置したワードの数がカウントされます。"
"[english]DOTA_Item_Desc_Strange_Modifier_Wards_Placed"	"Adding this Strange Modifier to a strange item of your choice will allow it to also track the number of wards you place while wearing it."
"DOTA_Item_Strange_Modifier_Gold_Earned"	"ストレンジモディファイア：獲得ゴールド"
"[english]DOTA_Item_Strange_Modifier_Gold_Earned"	"Strange Modifier: Gold Earned"
"DOTA_Item_Desc_Strange_Modifier_Gold_Earned"	"選択したストレンジアイテムにこのストレンジモディファイアを追加することによって、着用している間に獲得したゴールドの量がカウントされます。獲得ゴールドのデータはマッチの終了時に更新されます。"
"[english]DOTA_Item_Desc_Strange_Modifier_Gold_Earned"	"Adding this Strange Modifier to a strange item of your choice will allow it to also track the amount of gold you earn while wearing it. The gold earned stat will update at the end of a match."
"DOTA_Item_Strange_Modifier_Gold_Spent"	"ストレンジモディファイア：消費ゴールド"
"[english]DOTA_Item_Strange_Modifier_Gold_Spent"	"Strange Modifier: Gold Spent"
"DOTA_Item_Desc_Strange_Modifier_Gold_Spent"	"選択したストレンジアイテムにこのストレンジモディファイアを追加することによって、着用している間に消費したゴールドの量がカウントされます。消費ゴールドのデータはマッチの終了時に更新されます。"
"[english]DOTA_Item_Desc_Strange_Modifier_Gold_Spent"	"Adding this Strange Modifier to a strange item of your choice will allow it to also track the amount of gold you spend while wearing it. The gold spent stat will update at the end of a match."
"DOTA_Item_Strange_Modifier_Towers_Destroyed"	"ストレンジモディファイア：破壊したタワー"
"[english]DOTA_Item_Strange_Modifier_Towers_Destroyed"	"Strange Modifier: Towers Destroyed"
"DOTA_Item_Disruptors_Weapon"	"Disruptor の武器"
"[english]DOTA_Item_Disruptors_Weapon"	"Disruptor's Weapon"
"DOTA_Item_Disruptors_Bracers"	"Disruptor の籠手"
"[english]DOTA_Item_Disruptors_Bracers"	"Disruptor's Bracers"
"DOTA_Item_Desc_Copy_of_Disruptors_Weapon"	"この新しいアイテムには説明がありません。"
"[english]DOTA_Item_Desc_Copy_of_Disruptors_Weapon"	"This new item has no description."
"DOTA_Item_Disruptors_Hair"	"Disruptor の髪型"
"[english]DOTA_Item_Disruptors_Hair"	"Disruptor's Hair"
"DOTA_Item_Desc_Copy_of_Disruptors_Bracers"	"この新しいアイテムには説明がありません。"
"[english]DOTA_Item_Desc_Copy_of_Disruptors_Bracers"	"This new item has no description."
"DOTA_Item_Desc_Copy_of_Disruptors_Hair"	"この新しいアイテムには説明がありません。"
"[english]DOTA_Item_Desc_Copy_of_Disruptors_Hair"	"This new item has no description."
"DOTA_Item_Disruptors_Shoulder_Armor"	"Disruptor の肩鎧"
"[english]DOTA_Item_Disruptors_Shoulder_Armor"	"Disruptor's Shoulder Armor"
"DOTA_Item_Desc_Copy_of_Disruptors_Back"	"この新しいアイテムには説明がありません。"
"[english]DOTA_Item_Desc_Copy_of_Disruptors_Back"	"This new item has no description."
"DOTA_Item_Desc_Copy_of_Disruptors_Shoulder_Armor"	"この新しいアイテムには説明がありません。"
"[english]DOTA_Item_Desc_Copy_of_Disruptors_Shoulder_Armor"	"This new item has no description."
"DOTA_Item_Wings_of_Davion_Shoulder_Armor"	"Wings of Davion の肩鎧"
"[english]DOTA_Item_Wings_of_Davion_Shoulder_Armor"	"Wings of Davion Shoulder Armor"
"DOTA_Item_Wings_of_Davion_Shield"	"Wings of Davion Shield"
"[english]DOTA_Item_Wings_of_Davion_Shield"	"Wings of Davion Shield"
"DOTA_Item_Hardened_Hunters_Bracer"	"Hardened Hunter の籠手"
"[english]DOTA_Item_Hardened_Hunters_Bracer"	"Hardened Hunter's Bracer"
"DOTA_Item_Hardened_Hunters_Shoulder_Armor"	"Hardened Hunter の肩鎧"
"[english]DOTA_Item_Hardened_Hunters_Shoulder_Armor"	"Hardened Hunter's Shoulder Armor"
"DOTA_Item_Hardened_Hunters_Mask"	"Hardened Hunter のマスク"
"[english]DOTA_Item_Hardened_Hunters_Mask"	"Hardened Hunter's Mask"
"DOTA_Item_Desc_Strange_Modifier_Towers_Destroyed"	"選択したストレンジアイテムにこのストレンジモディファイアを追加することによって、着用している間に破壊したタワーの数がカウントされます。"
"[english]DOTA_Item_Desc_Strange_Modifier_Towers_Destroyed"	"Adding this Strange Modifier to a strange item of your choice will allow it to also track the number of towers you destroy while wearing it."
"DOTA_WearableType_Tusk"	"牙"
"[english]DOTA_WearableType_Tusk"	"Tusk"
"DOTA_Item_Desc_Disruptors_Weapon"	""
"[english]DOTA_Item_Desc_Disruptors_Weapon"	""
"DOTA_Item_Skeleton_Kings_head"	"Skeleton King の頭部"
"[english]DOTA_Item_Skeleton_Kings_head"	"Skeleton King's head"
"DOTA_Item_Skeleton_Kings_Weapon"	"Skeleton King の武器"
"[english]DOTA_Item_Skeleton_Kings_Weapon"	"Skeleton King's Weapon"
"DOTA_Item_Skeleton_Kings_Shoulder"	"Skeleton King の肩"
"[english]DOTA_Item_Skeleton_Kings_Shoulder"	"Skeleton King's Shoulder"
"DOTA_Item_Skeleton_Kings_Gauntlet"	"Skeleton King の篭手"
"[english]DOTA_Item_Skeleton_Kings_Gauntlet"	"Skeleton King's Gauntlet"
"DOTA_Item_Skeleton_Kings_Cape"	"Skeleton King の肩マント"
"[english]DOTA_Item_Skeleton_Kings_Cape"	"Skeleton King's Cape"
"DOTA_Item_Desc_Light_Cape_of_Sir_Davion"	"Dragon Knights の強みはその腕っ節や剣さばきではなく、強靭な精神である。"
"[english]DOTA_Item_Desc_Light_Cape_of_Sir_Davion"	"The strength of a dragon knight lies not in his arm or sword, but in his heart."
"DOTA_Item_Desc_Pauldron_of_Sir_Davion"	"Dragon Knight を守っているのは鎧ではなく、彼の信念である。"
"[english]DOTA_Item_Desc_Pauldron_of_Sir_Davion"	"A dragon knight is protected not by armor, but his faith."
"DOTA_Item_Desc_Dragonbone_Helm_of_Sir_Davion"	"成功したドラゴン騎士はいくつかの誇らしい傷を持っています。打たれた者で長生きする者はほとんど居ませんから。"
"[english]DOTA_Item_Desc_Dragonbone_Helm_of_Sir_Davion"	"Successful dragon knights boast few scars. The ones that get hit rarely live long."
"DOTA_Item_Enameled_Shield_of_Sir_Davion"	"Enameled Shield of Sir Davion"
"[english]DOTA_Item_Enameled_Shield_of_Sir_Davion"	"Enameled Shield of Sir Davion"
"DOTA_Item_Desc_Enameled_Shield_of_Sir_Davion"	"Dragon knight のシールドは時として彼の剣よりも重要である。ドラゴンは常に先制攻撃を加える。"
"[english]DOTA_Item_Desc_Enameled_Shield_of_Sir_Davion"	"A dragon knight's shield is often more important than his sword. Dragons always strike first."
"DOTA_Item_Edgebearers_Helm"	"Edgebearer の兜"
"[english]DOTA_Item_Edgebearers_Helm"	"Edgebearer's Helm"
"DOTA_Item_Death_Mask_of_the_Brave"	"Death Mask of the Brave"
"[english]DOTA_Item_Death_Mask_of_the_Brave"	"Death Mask of the Brave"
"DOTA_Item_Desc_Death_Mask_of_the_Brave"	"偉大なる獣の顔に、Juggernauty は勇気を見出した。その頭蓋骨より作り出されたマスクを見て、Juggernaut の敵は死を予見する。"
"[english]DOTA_Item_Desc_Death_Mask_of_the_Brave"	"In the face of the great beast, Juggernaut saw bravery.  In the mask made from the creature's skull, Juggernaut's foes see death."
"DOTA_Item_Sacral_Apparel"	"Sacral Apparel"
"[english]DOTA_Item_Sacral_Apparel"	"Sacral Apparel"
"DOTA_Item_Ancient_Mask_of_Intimidation"	"Ancient Mask of Intimidation"
"[english]DOTA_Item_Ancient_Mask_of_Intimidation"	"Ancient Mask of Intimidation"
"DOTA_Item_Radiant_crystal_shoulder_armor"	"Radiant crystal の肩鎧"
"[english]DOTA_Item_Radiant_crystal_shoulder_armor"	"Radiant Crystal Shoulder Armor"
"DOTA_Item_Pugnas_Head"	"Pugna の頭部"
"[english]DOTA_Item_Pugnas_Head"	"Pugna's Head"
"DOTA_Item_Pugnas_Cape"	"Pugna の肩マント"
"[english]DOTA_Item_Pugnas_Cape"	"Pugna's Cape"
"DOTA_Item_Pugnas_Bracers"	"Pugna の籠手"
"[english]DOTA_Item_Pugnas_Bracers"	"Pugna's Bracers"
"DOTA_Item_Pugnas_Weapon"	"Pugna の武器"
"[english]DOTA_Item_Pugnas_Weapon"	"Pugna's Weapon"
"DOTA_Item_Pugnas_Belt"	"Pugna のベルト"
"[english]DOTA_Item_Pugnas_Belt"	"Pugna's Belt"
"DOTA_Item_Desc_Copy_of_Brewmasters_Staff"	"この新しいアイテムには説明がありません。"
"[english]DOTA_Item_Desc_Copy_of_Brewmasters_Staff"	"This new item has no description."
"DOTA_Item_Brewmasters_Bracers"	"Brewmaster の籠手"
"[english]DOTA_Item_Brewmasters_Bracers"	"Brewmaster's Bracers"
"DOTA_Item_Desc_Copy_of_Brewmasters_Barrel"	"この新しいアイテムには説明がありません。"
"[english]DOTA_Item_Desc_Copy_of_Brewmasters_Barrel"	"This new item has no description."
"DOTA_Item_Desc_Copy_of_Brewmasters_Backpack"	"この新しいアイテムには説明がありません。"
"[english]DOTA_Item_Desc_Copy_of_Brewmasters_Backpack"	"This new item has no description."
"DOTA_Item_Rikis_Shoulder_Armor"	"Riki の肩鎧"
"[english]DOTA_Item_Rikis_Shoulder_Armor"	"Riki's Shoulder Armor"
"DOTA_Item_Desc_Ancient_Mask_of_Intimidation"	"どんな恐怖がこのマスクをこのような形に形成したのかと思う者の数は少なくない。長い間忘れられてきた地下生物の後姿を現しているという者もいれば、悪魔の顔であると言う者もいる。真実を知るのはJuggernaut ただ1人である。"
"[english]DOTA_Item_Desc_Ancient_Mask_of_Intimidation"	"Many wonder what horrors inspired the shape of this mask.  Some believe it shows the back of some long-forgotten subterranean creature.  Others say it is the face of a demon.  Only Juggernaut knows for sure."
"DOTA_Item_Desc_Radiant_Crystal_Bracer"	"Radiant のエッセンスと命を持った水を注入した篭手。Dire として戦っているときに着用することは、まさに皮肉でしかない。"
"[english]DOTA_Item_Desc_Radiant_Crystal_Bracer"	"Bracers that infuse the living waters with Radiant essence. When fighting for the Dire, Morphling wears them with purely ironic intent."
"DOTA_Item_Desc_Force_Staff"	"ちょっとした一押しが必要なときがあります。"
"[english]DOTA_Item_Desc_Force_Staff"	"Sometimes a little push is all you need."
"DOTA_Item_Desc_Copy_of_BladedStaff_of_the_Reaper"	"この新しいアイテムには説明がありません。"
"[english]DOTA_Item_Desc_Copy_of_BladedStaff_of_the_Reaper"	"This new item has no description."
"DOTA_Item_Desc_Copy_of_Makeshift_Sword_of_the_Reaper"	"この新しいアイテムには説明がありません。"
"[english]DOTA_Item_Desc_Copy_of_Makeshift_Sword_of_the_Reaper"	"This new item has no description."
"DOTA_Item_Bloodmist_Belt"	"Bloodmist Belt"
"[english]DOTA_Item_Bloodmist_Belt"	"Bloodmist Belt"
"DOTA_Item_Desc_Bloodmist_Helm"	"頭にのしかかるこの兜の重みで首を強化する。"
"[english]DOTA_Item_Desc_Bloodmist_Helm"	"This helm sits heavily on the head to strengthen the neck below."
"DOTA_Item_Bracers_of_Profound_Perfection"	"Bracers of Profound Perfection"
"[english]DOTA_Item_Bracers_of_Profound_Perfection"	"Bracers of Profound Perfection"
"DOTA_Item_Desc_Bracers_of_Profound_Perfection"	"Invoker の想像を絶する力に嫉妬している魔道師は大勢いる反面、単に彼の独創的で比類なきセンスに嫉妬している者もいる。"
"[english]DOTA_Item_Desc_Bracers_of_Profound_Perfection"	"While many wizards are jealous of the Invoker's unimaginable power, others are merely jealous of his peerless taste."
"DOTA_Item_Crest_of_the_Magus_Magnus"	"Crest of the Magus Magnus"
"[english]DOTA_Item_Crest_of_the_Magus_Magnus"	"Crest of the Magus Magnus"
"DOTA_Item_Desc_Crest_of_the_Magus_Magnus"	"神秘的なWex勢力の電力を帯びたクレスト"
"[english]DOTA_Item_Desc_Crest_of_the_Magus_Magnus"	"A crest that crackles with the arcane might of Wex."
"DOTA_Item_Desc_Hood_of_Endless_Intellect"	"Invoker はこの頭巾の魔法知性ブースト呪文を必要をすることはほとんど無い。彼はあなたが今後理解できるようになる事柄よりも遥か上の知性を持っている。"
"[english]DOTA_Item_Desc_Hood_of_Endless_Intellect"	"The Invoker has little need for this hood's magical intellect boosting enchantments. He is already far more intelligent than you could possibly ever comprehend."
"DOTA_Item_Strange_Modifier_Bounty_TrackedKills"	"ストレンジモディファイア： Track キル"
"[english]DOTA_Item_Strange_Modifier_Bounty_TrackedKills"	"Strange Modifier: Tracked Kills"
"DOTA_Item_Desc_Strange_Modifier_Bounty_TrackedKills"	"選択したストレンジアイテムにこのストレンジモディファイアを追加することによって、Bounty Hunter が着用している間に　Track 状態で死んだ敵の数がカウントされます。"
"[english]DOTA_Item_Desc_Strange_Modifier_Bounty_TrackedKills"	"Adding this Strange Modifier to a strange item of your choice will allow it to also count the number of dying enemies you were Tracking while wearing it as Bounty Hunter."
"DOTA_Item_Strange_Modifier_Bounty_TrackedInvisKills"	"ストレンジモディファイア：Track の不可視キル"
"[english]DOTA_Item_Strange_Modifier_Bounty_TrackedInvisKills"	"Strange Modifier: Tracked Invisible Kills"
"DOTA_Item_Desc_Strange_Modifier_Bounty_TrackedInvisKills"	"選択したストレンジアイテムにこのストレンジモディファイアを追加することによって、Bounty Hunter が着用している間に　Track 状態にあり、不可視状態で死んだ敵の数がカウントされます。"
"[english]DOTA_Item_Desc_Strange_Modifier_Bounty_TrackedInvisKills"	"Adding this Strange Modifier to a strange item of your choice will allow it to also count the number of dying invisible enemies you were Tracking while wearing it as Bounty Hunter."
"DOTA_Item_Strange_Modifier_Bounty_InvisJinadaHits"	"ストレンジモディファイア: 不可視の Jinada 攻撃"
"[english]DOTA_Item_Strange_Modifier_Bounty_InvisJinadaHits"	"Strange Modifier: Invisible Jinada Strikes"
"DOTA_Item_Desc_Strange_Modifier_Bounty_InvisJinadaHits"	"選択したストレンジアイテムにこのストレンジモディファイアを追加することによって、Bounty Hunter が着用している間に、不可視の状態から Jinada による攻撃で可視状態になった数がカウントされる。"
"[english]DOTA_Item_Desc_Strange_Modifier_Bounty_InvisJinadaHits"	"Adding this Strange Modifier to a strange item of your choice will allow it to also count the number of times you break invisibility with a Jinada strike on an enemy hero while wearing it as Bounty Hunter."
"DOTA_Item_Strange_Modifier_Bounty_TrackBountyGold"	"ストレンジモディファイア： Track での獲得ゴールド"
"[english]DOTA_Item_Strange_Modifier_Bounty_TrackBountyGold"	"Strange Modifier: Track Bounty Gold"
"DOTA_Item_Desc_Strange_Modifier_Bounty_TrackBountyGold"	"選択したストレンジアイテムにこのストレンジモディファイアを追加することによって、Bounty Hunter が着用している間に　Track 状態の敵の死から得たボーナスゴールドの合計がカウントされます。"
"[english]DOTA_Item_Desc_Strange_Modifier_Bounty_TrackBountyGold"	"Adding this Strange Modifier to a strange item of your choice will allow it to also count the total bonus gold you've earned from Tracked kills while wearing it as Bounty Hunter."
"DOTA_Item_Strange_Modifier_Tide_GoodRavages"	"ストレンジモディファイア：4人を Ravage"
"[english]DOTA_Item_Strange_Modifier_Tide_GoodRavages"	"Strange Modifier: Quad Ravages"
"DOTA_Item_Desc_Strange_Modifier_Tide_GoodRavages"	"選択したストレンジアイテムにこのストレンジモディファイアを追加することによって、Tidehunter が着用している間に少なくとも4人のヒーローを攻撃した Ravages の回数がカウントされます。"
"[english]DOTA_Item_Desc_Strange_Modifier_Tide_GoodRavages"	"Adding this Strange Modifier to a strange item of your choice will allow it to also count the number of your Ravages that hit at least four enemy Heroes while wearing it as Tidehunter."
"DOTA_Item_Strange_Modifier_Windrunner_DoubleShackles"	"ストレンジモディファイア： ダブルShackle"
"[english]DOTA_Item_Strange_Modifier_Windrunner_DoubleShackles"	"Strange Modifier: Double Shackles"
"DOTA_Item_Desc_Strange_Modifier_Windrunner_DoubleShackles"	"選択したストレンジアイテムにこのストレンジモディファイアを追加することによって、Windrunner として着用している間に二人の敵ヒーローをくくりつけた Shockleshot　の数がカウントされます。"
"[english]DOTA_Item_Desc_Strange_Modifier_Windrunner_DoubleShackles"	"Adding this Strange Modifier to a strange item of your choice will allow it to also count the number of your Shackleshots that bind two enemy Heroes while wearing it as Windrunner."
"DOTA_Item_Strange_Modifier_Windrunner_GoodPowershots"	"ストレンジモディファイア：複数ヒーローを Powershot"
"[english]DOTA_Item_Strange_Modifier_Windrunner_GoodPowershots"	"Strange Modifier: Multi-hero Powershots"
"DOTA_Item_Desc_Strange_Modifier_Windrunner_GoodPowershots"	"選択したストレンジアイテムにこのストレンジモディファイアを追加することによって、Windrunner として着用している間に少なくとも2人の敵ヒーローを攻撃した Shockleshot　の数がカウントされます。"
"[english]DOTA_Item_Desc_Strange_Modifier_Windrunner_GoodPowershots"	"Adding this Strange Modifier to a strange item of your choice will allow it to also count the number of your Powershots that hit at least two enemy Heroes while wearing it as Windrunner."
"DOTA_Item_Strange_Modifier_Invoker_SunstrikeKills"	"ストレンジモディファイア： Sunstrike キル"
"[english]DOTA_Item_Strange_Modifier_Invoker_SunstrikeKills"	"Strange Modifier: Sunstrike Kills"
"DOTA_Item_Desc_Strange_Modifier_Invoker_SunstrikeKills"	"選択したストレンジアイテムにこのストレンジモディファイアを追加することによって、Invoker が着用している間に Sunstrike で倒した敵の数がカウントされます。"
"[english]DOTA_Item_Desc_Strange_Modifier_Invoker_SunstrikeKills"	"Adding this Strange Modifier to a strange item of your choice will allow it to also count the number of enemies you've killed with Sunstrike as Invoker."
"DOTA_Item_Strange_Modifier_Couriers_Purchased"	"ストレンジモディファイア：クーリエ購入"
"[english]DOTA_Item_Strange_Modifier_Couriers_Purchased"	"Strange Modifier: Couriers Purchased"
"DOTA_Item_Desc_Strange_Modifier_Couriers_Purchased"	"選択したストレンジアイテムにこのストレンジモディファイアを追加することによって、購入したクーリエの数がカウントされます。"
"[english]DOTA_Item_Desc_Strange_Modifier_Couriers_Purchased"	"Adding this Strange Modifier to a strange item of your choice will allow it to also count the number of Couriers purchased."
"DOTA_Item_Strange_Modifier_Wards_Purchased"	"ストレンジモディファイア：ワード購入"
"[english]DOTA_Item_Strange_Modifier_Wards_Purchased"	"Strange Modifier: Wards Purchased"
"DOTA_Item_Desc_Strange_Modifier_Wards_Purchased"	"このパックには、 Runesmith's Chisel と Wards Purchased Gem が含まれます。 Chisel は任意のアイテムにソケットを追加するのに使用することができ、 Wards Purchased Gem はソケットにつけることができます。"
"[english]DOTA_Item_Desc_Strange_Modifier_Wards_Purchased"	"This pack contains a Runesmith's Chisel and a Wards Purchased Gem. The chisel can be used to add a socket to any item and the Wards Purchased Gem can be placed in a socket."
"DOTA_Item_Strange_Modifier_Tide_EnemiesGushed"	"ストレンジモディファイア：Gush した敵"
"[english]DOTA_Item_Strange_Modifier_Tide_EnemiesGushed"	"Strange Modifier: Enemies Gushed"
"DOTA_Item_Desc_Strange_Modifier_Tide_EnemiesGushed"	"選択したストレンジアイテムにこのストレンジモディファイアを追加することによって、Tidehunter が着用している間に Gush を受けた敵の数がカウントされます。"
"[english]DOTA_Item_Desc_Strange_Modifier_Tide_EnemiesGushed"	"Adding this Strange Modifier to a strange item of your choice will allow it to also count the number of enemies you've Gushed as Tidehunter."
"DOTA_Bundle_Desc_Juggernaut_Dauntless"	"Juggernaut 用の'The Dauntless' セットに含まれる全てのアイテム:"
"[english]DOTA_Bundle_Desc_Juggernaut_Dauntless"	"Includes all of the items in the 'The Dauntless' set for Juggernaut:"
"DOTA_Item_Bloodmist_Armor_Set"	"Bloodmist Armor セット"
"[english]DOTA_Item_Bloodmist_Armor_Set"	"Bloodmist Armor Set"
"DOTA_Bundle_Desc_Axe_Blood_Mist"	"Axe 用の'Bloodmist Armor' セットに含まれる全てのアイテム:"
"[english]DOTA_Bundle_Desc_Axe_Blood_Mist"	"Includes all of the items in the 'Bloodmist Armor' set for Axe:"
"DOTA_Item_Armor_of_Sir_Davion_Set"	"Armor of Sir Davion セット"
"[english]DOTA_Item_Armor_of_Sir_Davion_Set"	"Armor of Sir Davion Set"
"DOTA_Bundle_Desc_Dragon_Knight_Davion"	"Dragon Knight 用の'Armor of Sir Davion' セットに含まれる全てのアイテム:"
"[english]DOTA_Bundle_Desc_Dragon_Knight_Davion"	"Includes all of the items in the 'Armor of Sir Davion' set for Dragon Knight:"
"DOTA_Item_Armor_of_the_Purist_Champion_Set"	"Armor of the Purist Champion セット"
"[english]DOTA_Item_Armor_of_the_Purist_Champion_Set"	"Armor of the Purist Champion Set"
"DOTA_Bundle_Desc_Omniknight_Purist_Champion"	"Omniknight 用のArmor of the Purist Champion' セットに含まれる全てのアイテム:"
"[english]DOTA_Bundle_Desc_Omniknight_Purist_Champion"	"Includes all of the items in the 'Armor of the Purist Champion' set for Omniknight:"
"DOTA_Bundle_Desc_Witch_Doctor_Tale_Teller"	"Witch Doctor 用の 'Traveling Tale-Teller' セットに含まれる全てのアイテム:"
"[english]DOTA_Bundle_Desc_Witch_Doctor_Tale_Teller"	"Includes all of the items in the 'Traveling Tale-Teller' set for Witch Doctor:"
"DOTA_Item_Hardened_Hunters_Gear_Set"	"Hardened Hunter's Gear セット"
"[english]DOTA_Item_Hardened_Hunters_Gear_Set"	"Hardened Hunter's Gear Set"
"DOTA_Bundle_Desc_Bounty_Hunter_Hardened"	"Bounty Hunter 用の 'Hardened Hunter's Gear' セットに含まれる全てのアイテム:"
"[english]DOTA_Bundle_Desc_Bounty_Hunter_Hardened"	"Includes all of the items in the 'Hardened Hunter's Gear' set for Bounty Hunter:"
"DOTA_Item_Radiant_Crystal_Bindings_Set"	"Radiant Crystal Bindings セット"
"[english]DOTA_Item_Radiant_Crystal_Bindings_Set"	"Radiant Crystal Bindings Set"
"DOTA_Bundle_Desc_Morphling_Radiant_Crystal"	"Morphling 用の 'Radiant Crystal Bindings' セットに含まれる全てのアイテム:"
"[english]DOTA_Bundle_Desc_Morphling_Radiant_Crystal"	"Includes all of the items in the 'Radiant Crystal Bindings' set for Morphling:"
"DOTA_Item_The_Magus_Magnus_Set"	"Magus Magnus セット"
"[english]DOTA_Item_The_Magus_Magnus_Set"	"The Magus Magnus Set"
"DOTA_Bundle_Desc_Invoker_Magnus"	"Invoker 用の 'Magus Magnus' セットに含まれる全てのアイテム:"
"[english]DOTA_Bundle_Desc_Invoker_Magnus"	"Includes all of the items in the 'Magus Magnus' set for Invoker:"
"DOTA_Item_Death_Prophets_Dress"	"Death Prophet のドレス"
"[english]DOTA_Item_Death_Prophets_Dress"	"Death Prophet's Dress"
"DOTA_Item_Death_Prophets_Arms"	"Death Prophet の腕"
"[english]DOTA_Item_Death_Prophets_Arms"	"Death Prophet's Arms"
"DOTA_Item_Death_Prophets_Head"	"Death Prophet の髪型"
"[english]DOTA_Item_Death_Prophets_Head"	"Death Prophet's Head"
"DOTA_Item_Lanayas_hair"	"Lanayas の髪型"
"[english]DOTA_Item_Lanayas_hair"	"Lanayas hair"
"DOTA_Item_Lanayas_bracers_and_skirt"	"Lanayas bracers and skirt"
"[english]DOTA_Item_Lanayas_bracers_and_skirt"	"Lanayas bracers and skirt"
"DOTA_Item_Chaos_Knights_horse_head"	"Chaos Knights の馬の頭部"
"[english]DOTA_Item_Chaos_Knights_horse_head"	"Chaos Knights horse head"
"DOTA_Item_Chaos_Knight_weapon"	"Chaos Knight の武器"
"[english]DOTA_Item_Chaos_Knight_weapon"	"Chaos Knight weapon"
"DOTA_Item_Chaos_Knight_shield"	"Chaos Knight shield"
"[english]DOTA_Item_Chaos_Knight_shield"	"Chaos Knight shield"
"DOTA_Item_Obsidian_Destroyers_head"	"Obsidian Destroyers の頭部"
"[english]DOTA_Item_Obsidian_Destroyers_head"	"Obsidian Destroyers head"
"DOTA_Item_Obsidian_Destroyers_weapon"	"Obsidian Destroyer の武器"
"[english]DOTA_Item_Obsidian_Destroyers_weapon"	"Obsidian Destroyers weapon"
"DOTA_Item_Naga_Sirens_Hair"	"Naga Siren の髪型"
"[english]DOTA_Item_Naga_Sirens_Hair"	"Naga Siren's Hair"
"DOTA_Item_Crystal_Maidens_Cuffs"	"Crystal Maiden's Cuffs"
"[english]DOTA_Item_Crystal_Maidens_Cuffs"	"Crystal Maiden's Cuffs"
"DOTA_Item_Sand_Kings_Head"	"Sand King の頭部"
"[english]DOTA_Item_Sand_Kings_Head"	"Sand King's Head"
"DOTA_Item_Nyxs_Weapon"	"Nyx の武器"
"[english]DOTA_Item_Nyxs_Weapon"	"Nyx's Weapon"
"DOTA_Item_Desc_Copy_of_Nyxs_Weapon"	"この新しいアイテムには説明がありません。"
"[english]DOTA_Item_Desc_Copy_of_Nyxs_Weapon"	"This new item has no description."
"DOTA_Item_Nyxs_Helmet"	"Nyx の兜"
"[english]DOTA_Item_Nyxs_Helmet"	"Nyx's Helmet"
"DOTA_Item_Desc_Copy_of_Nyxs_Armor"	"この新しいアイテムには説明がありません。"
"[english]DOTA_Item_Desc_Copy_of_Nyxs_Armor"	"This new item has no description."
"DOTA_Item_Sand_Kings_Arms"	"Sand King の腕部"
"[english]DOTA_Item_Sand_Kings_Arms"	"Sand King's Arms"
"DOTA_Item_Assault_Armor_Belt"	"Assault Armor Belt"
"[english]DOTA_Item_Assault_Armor_Belt"	"Assault Armor Belt"
"DOTA_Item_Echinoderm_shield"	"Echinoderm shield"
"[english]DOTA_Item_Echinoderm_shield"	"Echinoderm shield"
"DOTA_Item_Spiked_Bracers_of_the_Ravager"	"Spiked Bracers of the Ravager"
"[english]DOTA_Item_Spiked_Bracers_of_the_Ravager"	"Spiked Bracers of the Ravager"
"DOTA_Item_Master_Assassins_Mask"	"Master Assassin のマスク"
"[english]DOTA_Item_Master_Assassins_Mask"	"Master Assassin's Mask"
"DOTA_Item_Master_Assassins_Weapon"	"Master Assassin の武器"
"[english]DOTA_Item_Master_Assassins_Weapon"	"Master Assassins Weapon"
"DOTA_Item_Master_Assassins_Offhand_Weapon"	"Master Assassins の武器（逆腕）"
"[english]DOTA_Item_Master_Assassins_Offhand_Weapon"	"Master Assassins Offhand Weapon"
"DOTA_Item_Bracers_of_the_Hierophant"	"Bracers of the Hierophant"
"[english]DOTA_Item_Bracers_of_the_Hierophant"	"Bracers of the Hierophant"
"DOTA_Item_Desc_Obsidian_Destroyers_head"	"この新しいアイテムには説明がありません。"
"[english]DOTA_Item_Desc_Obsidian_Destroyers_head"	"This new item has no description."
"DOTA_Item_Phantom_Assassins_Head"	"Phantom Assassin の頭部"
"[english]DOTA_Item_Phantom_Assassins_Head"	"Phantom Assassin's Head"
"DOTA_Item_Rubicks_Cape"	"Rubick の肩マント"
"[english]DOTA_Item_Rubicks_Cape"	"Rubick's Cape"
"DOTA_Item_Desc_Copy_of_Rubicks_Staff"	"この新しいアイテムには説明がありません。"
"[english]DOTA_Item_Desc_Copy_of_Rubicks_Staff"	"This new item has no description."
"DOTA_Item_Rubicks_Shoulder_Armor"	"Rubick の肩鎧"
"[english]DOTA_Item_Rubicks_Shoulder_Armor"	"Rubick's Shoulder Armor"
"DOTA_Item_Desc_Copy_of_Rubicks_Cape"	"この新しいアイテムには説明がありません。"
"[english]DOTA_Item_Desc_Copy_of_Rubicks_Cape"	"This new item has no description."
"DOTA_Item_Lycans_Head"	"Lycan の頭部"
"[english]DOTA_Item_Lycans_Head"	"Lycan's Head"
"DOTA_Item_Lycans_Belt"	"Lycan のベルト"
"[english]DOTA_Item_Lycans_Belt"	"Lycan's Belt"
"DOTA_Item_Desc_Copy_of_Necrolytes_Sickle"	"この新しいアイテムには説明がありません。"
"[english]DOTA_Item_Desc_Copy_of_Necrolytes_Sickle"	"This new item has no description."
"DOTA_Item_Necrolytes_Headdress"	"Necrolyte の頭飾り"
"[english]DOTA_Item_Necrolytes_Headdress"	"Necrolyte's Headdress"
"DOTA_Item_Desc_Copy_of_Necrolytes_Beard"	"この新しいアイテムには説明がありません。"
"[english]DOTA_Item_Desc_Copy_of_Necrolytes_Beard"	"This new item has no description."
"DOTA_Item_Desc_Copy_of_Necrolytes_Headdress"	"この新しいアイテムには説明がありません。"
"[english]DOTA_Item_Desc_Copy_of_Necrolytes_Headdress"	"This new item has no description."
"DOTA_Item_AntiMages_Head"	"Anti-Mage の頭部"
"[english]DOTA_Item_AntiMages_Head"	"Anti-Mage's Head"
"DOTA_Item_AntiMages_Shoulder"	"Anti-Mage の肩部"
"[english]DOTA_Item_AntiMages_Shoulder"	"Anti-Mage's Shoulder"
"DOTA_Item_AntiMages_Arms"	"Anti-Mage の腕部"
"[english]DOTA_Item_AntiMages_Arms"	"Anti-Mage's Arms"
"DOTA_Item_AntiMages_Belt"	"Anti-Mage のベルト"
"[english]DOTA_Item_AntiMages_Belt"	"Anti-Mage's Belt"
"DOTA_Item_Lone_Druids_Weapon"	"Lone Druid の武器"
"[english]DOTA_Item_Lone_Druids_Weapon"	"Lone Druid's Weapon"
"DOTA_Item_Desc_Copy_of_Chens_Staff"	"この新しいアイテムには説明がありません。"
"[english]DOTA_Item_Desc_Copy_of_Chens_Staff"	"This new item has no description."
"DOTA_Item_Chens_Helmet"	"Chen の兜"
"[english]DOTA_Item_Chens_Helmet"	"Chen's Helmet"
"DOTA_Item_Desc_Copy_of_Chens_Mount"	"この新しいアイテムには説明がありません。"
"[english]DOTA_Item_Desc_Copy_of_Chens_Mount"	"This new item has no description."
"DOTA_Item_Chens_Bracers"	"Chen の籠手"
"[english]DOTA_Item_Chens_Bracers"	"Chen's Bracers"
"DOTA_Item_Desc_Copy_of_Chens_Helmet"	"この新しいアイテムには説明がありません。"
"[english]DOTA_Item_Desc_Copy_of_Chens_Helmet"	"This new item has no description."
"DOTA_Item_Chens_Shoulder_Armor"	"Chen の肩鎧"
"[english]DOTA_Item_Chens_Shoulder_Armor"	"Chen's Shoulder Armor"
"DOTA_Item_Desc_Copy_of_Chens_Bracers"	"この新しいアイテムには説明がありません。"
"[english]DOTA_Item_Desc_Copy_of_Chens_Bracers"	"This new item has no description."
"DOTA_Item_Desc_Copy_of_Chens_Shoulder_Armor"	"この新しいアイテムには説明がありません。"
"[english]DOTA_Item_Desc_Copy_of_Chens_Shoulder_Armor"	"This new item has no description."
"DOTA_Item_Treants_Head"	"Treants の頭部"
"[english]DOTA_Item_Treants_Head"	"Treants' Head"
"DOTA_Item_Treants_Foliage"	"Treants の枝葉"
"[english]DOTA_Item_Treants_Foliage"	"Treants' Foliage"
"DOTA_Item_Desc_Copy_of_Treants_Head"	"この新しいアイテムには説明がありません。"
"[english]DOTA_Item_Desc_Copy_of_Treants_Head"	"This new item has no description."
"DOTA_Item_Treants_Hands"	"Treants の手"
"[english]DOTA_Item_Treants_Hands"	"Treants' Hands"
"DOTA_Item_Desc_Copy_of_Treants_Foliage"	"この新しいアイテムには説明がありません。"
"[english]DOTA_Item_Desc_Copy_of_Treants_Foliage"	"This new item has no description."
"DOTA_Item_Treants_Feet"	"Treants の脚"
"[english]DOTA_Item_Treants_Feet"	"Treants' Feet"
"DOTA_Item_Desc_Copy_of_Treants_Hands"	"この新しいアイテムには説明がありません。"
"[english]DOTA_Item_Desc_Copy_of_Treants_Hands"	"This new item has no description."
"DOTA_Item_Treants_Belt"	"Treants のベルト"
"[english]DOTA_Item_Treants_Belt"	"Treants' Belt"
"DOTA_Item_Desc_Copy_of_Treants_Feet"	"この新しいアイテムには説明がありません。"
"[english]DOTA_Item_Desc_Copy_of_Treants_Feet"	"This new item has no description."
"DOTA_Item_Beast_of_War_Belt"	"Beast of War Belt"
"[english]DOTA_Item_Beast_of_War_Belt"	"Beast of War Belt"
"DOTA_Item_Beast_of_War_Bracers"	"Beast of War Bracers"
"[english]DOTA_Item_Beast_of_War_Bracers"	"Beast of War Bracers"
"DOTA_Item_Savage_Beast_Arms"	"Savage Beast の腕部"
"[english]DOTA_Item_Savage_Beast_Arms"	"Savage Beast Arms"
"DOTA_Item_Savage_Beast_Belt"	"Savage Beast Belt"
"[english]DOTA_Item_Savage_Beast_Belt"	"Savage Beast Belt"
"DOTA_Item_Savage_Beast_Weapon_Right"	"Savage Beast の武器（右）"
"[english]DOTA_Item_Savage_Beast_Weapon_Right"	"Savage Beast Weapon (Right)"
"DOTA_Item_Savage_Beast_Weapon_Left"	"Savage Beast の武器（左）"
"[english]DOTA_Item_Savage_Beast_Weapon_Left"	"Savage Beast Weapon (Left)"
"DOTA_Item_Savage_Bracer"	"Savage の籠手"
"[english]DOTA_Item_Savage_Bracer"	"Savage Bracer"
"DOTA_Item_Savage_Belt"	"Savage Belt"
"[english]DOTA_Item_Savage_Belt"	"Savage Belt"
"DOTA_Item_Dooms_Weapon"	"Doom の武器"
"[english]DOTA_Item_Dooms_Weapon"	"Doom's Weapon"
"DOTA_Item_Dooms_Helm"	"Doom の兜"
"[english]DOTA_Item_Dooms_Helm"	"Doom's Helm"
"DOTA_Item_Desc_Copy_of_Dooms_Weapon"	"この新しいアイテムには説明がありません。"
"[english]DOTA_Item_Desc_Copy_of_Dooms_Weapon"	"This new item has no description."
"DOTA_Item_Dooms_Shoulder_Armor"	"Doom の肩鎧"
"[english]DOTA_Item_Dooms_Shoulder_Armor"	"Doom's Shoulder Armor"
"DOTA_Item_Desc_Copy_of_Dooms_Helm"	"この新しいアイテムには説明がありません。"
"[english]DOTA_Item_Desc_Copy_of_Dooms_Helm"	"This new item has no description."
"DOTA_Item_Dooms_Bracers"	"Doom の籠手"
"[english]DOTA_Item_Dooms_Bracers"	"Doom's Bracers"
"DOTA_Item_Desc_Copy_of_Dooms_Shoulder_Armor"	"この新しいアイテムには説明がありません。"
"[english]DOTA_Item_Desc_Copy_of_Dooms_Shoulder_Armor"	"This new item has no description."
"DOTA_Item_Dooms_Belt"	"Doom のベルト"
"[english]DOTA_Item_Dooms_Belt"	"Doom's Belt"
"DOTA_Item_Desc_Copy_of_Dooms_Bracers"	"この新しいアイテムには説明がありません。"
"[english]DOTA_Item_Desc_Copy_of_Dooms_Bracers"	"This new item has no description."
"DOTA_Item_Desc_Copy_of_Dooms_Belt"	"この新しいアイテムには説明がありません。"
"[english]DOTA_Item_Desc_Copy_of_Dooms_Belt"	"This new item has no description."
"DOTA_Item_Desc_Copy_of_Dooms_Wings"	"この新しいアイテムには説明がありません。"
"[english]DOTA_Item_Desc_Copy_of_Dooms_Wings"	"This new item has no description."
"DOTA_Item_Warlocks_Weapon"	"Warlock の武器"
"[english]DOTA_Item_Warlocks_Weapon"	"Warlock's Weapon"
"DOTA_Item_Warlocks_Offhand_Weapon"	"Warlock の武器（逆腕）"
"[english]DOTA_Item_Warlocks_Offhand_Weapon"	"Warlock's Off-hand Weapon"
"DOTA_Item_Warlocks_Arms"	"Warlock の腕部"
"[english]DOTA_Item_Warlocks_Arms"	"Warlock's Arms"
"DOTA_Item_Shadow_Shamans_Weapon"	"Shadow Shaman の武器"
"[english]DOTA_Item_Shadow_Shamans_Weapon"	"Shadow Shaman's Weapon"
"DOTA_Item_Shadow_Shamans_Offhand_Weapon"	"Shadow Shaman の武器（逆腕）"
"[english]DOTA_Item_Shadow_Shamans_Offhand_Weapon"	"Shadow Shaman's Off-hand Weapon"
"DOTA_Item_Desc_Copy_of_Shadow_Shamans_Weapon"	"この新しいアイテムには説明がありません。"
"[english]DOTA_Item_Desc_Copy_of_Shadow_Shamans_Weapon"	"This new item has no description."
"DOTA_Item_Shadow_Shamans_Headdress"	"Shadow Shaman の頭飾り"
"[english]DOTA_Item_Shadow_Shamans_Headdress"	"Shadow Shaman's Headdress"
"DOTA_Item_Desc_Copy_of_Shadow_Shamans_Offhand_Weapon"	"この新しいアイテムには説明がありません。"
"[english]DOTA_Item_Desc_Copy_of_Shadow_Shamans_Offhand_Weapon"	"This new item has no description."
"DOTA_Item_Desc_Copy_of_Shadow_Shamans_Headdress"	"この新しいアイテムには説明がありません。"
"[english]DOTA_Item_Desc_Copy_of_Shadow_Shamans_Headdress"	"This new item has no description."
"DOTA_Item_Desc_Copy_of_Shadow_Shamans_Armor"	"この新しいアイテムには説明がありません。"
"[english]DOTA_Item_Desc_Copy_of_Shadow_Shamans_Armor"	"This new item has no description."
"DOTA_Item_Shadow_Shamans_Head"	"Shadow Shaman の頭部"
"[english]DOTA_Item_Shadow_Shamans_Head"	"Shadow Shaman's Head"
"DOTA_Item_Desc_Copy_of_Shadow_Shamans_Stuff"	"この新しいアイテムには説明がありません。"
"[english]DOTA_Item_Desc_Copy_of_Shadow_Shamans_Stuff"	"This new item has no description."
"DOTA_Item_Strange_Modifier_Axe_Culls"	"ストレンジモディファイア： Cull した敵"
"[english]DOTA_Item_Strange_Modifier_Axe_Culls"	"Strange Modifier: Enemies Culled"
"DOTA_Item_Desc_Strange_Modifier_Axe_Culls"	"選択したストレンジアイテムにこのストレンジモディファイア追加することによって、Axeが着用している間にCulling Blade で攻撃した敵の数がカウントされます。"
"[english]DOTA_Item_Desc_Strange_Modifier_Axe_Culls"	"Adding this Strange Modifier to a strange item of your choice will allow it to also count the number of enemies you've Culled while wearing it as Axe."
"DOTA_Item_Strange_Modifier_Axe_BattleHungerKills"	"ストレンジモディファイア： Battle Hunger キル"
"[english]DOTA_Item_Strange_Modifier_Axe_BattleHungerKills"	"Strange Modifier: Battle Hunger Kills"
"DOTA_Item_Desc_Strange_Modifier_Axe_BattleHungerKills"	"選択したストレンジアイテムにこのストレンジモディファイア追加することによって、Axeが着用している間に Battle Hunger によって倒した敵の数がカウントされます。"
"[english]DOTA_Item_Desc_Strange_Modifier_Axe_BattleHungerKills"	"Adding this Strange Modifier to a strange item of your choice will allow it to also count the number of enemies you've killed with Battle Hunger while wearing it as Axe."
"DOTA_Item_Strange_Modifier_Axe_LowHealthKills"	"ストレンジモディファイア：Axe Near Death キル"
"[english]DOTA_Item_Strange_Modifier_Axe_LowHealthKills"	"Strange Modifier: Axe Near Death Kills"
"DOTA_Item_Desc_Strange_Modifier_Axe_LowHealthKills"	"選択したストレンジアイテムにこのストレンジモディファイアを追加することによって、Axeが着用している間に ヘルスが15%以下の状態で倒した敵の数がカウントされます。"
"[english]DOTA_Item_Desc_Strange_Modifier_Axe_LowHealthKills"	"Adding this Strange Modifier to a strange item of your choice will allow it to also count the number of enemies you've killed while having less than 15% of your health while wearing it as Axe."
"DOTA_Item_Strange_Modifier_Axe_CalledDamageDone"	"ストレンジモディファイア：Call の与ダメージ"
"[english]DOTA_Item_Strange_Modifier_Axe_CalledDamageDone"	"Strange Modifier: Call Damage Done"
"DOTA_Item_Desc_Strange_Modifier_Axe_CalledDamageDone"	"選択したストレンジアイテムにこのストレンジモディファイア追加することによって、Axeが着用している間に Berserker's Call の効果によって敵に与えたダメージ量がカウントされます。"
"[english]DOTA_Item_Desc_Strange_Modifier_Axe_CalledDamageDone"	"Adding this Strange Modifier to a strange item of your choice will allow it to also count the amount of damage you've done to enemies under the effects of your Berserker's Call while wearing it as Axe."
"DOTA_Item_Strange_Modifier_Axe_CalledDamageTaken"	"ストレンジモディファイア： Call の受ダメージ"
"[english]DOTA_Item_Strange_Modifier_Axe_CalledDamageTaken"	"Strange Modifier: Call Damage Taken"
"DOTA_Item_Desc_Strange_Modifier_Axe_CalledDamageTaken"	"選択したストレンジアイテムにこのストレンジモディファイア追加することによって、Axeが着用している間に Berserker's Call の効果によって敵から受けたダメージ量がされます。"
"[english]DOTA_Item_Desc_Strange_Modifier_Axe_CalledDamageTaken"	"Adding this Strange Modifier to a strange item of your choice will allow it to also count the amount of damage you've taken from enemies under the effects of your Berserker's Call while wearing it as Axe."
"DOTA_Item_Strange_Modifier_Invoker_TornadoKills"	"ストレンジモディファイア：Tornado キル"
"[english]DOTA_Item_Strange_Modifier_Invoker_TornadoKills"	"Strange Modifier: Tornado Kills"
"DOTA_Item_Desc_Strange_Modifier_Invoker_TornadoKills"	"選択したストレンジアイテムにこのストレンジモディファイアを追加することによって、Invoker が着用している間に Tornado で倒した敵の数がカウントされます。"
"[english]DOTA_Item_Desc_Strange_Modifier_Invoker_TornadoKills"	"Adding this Strange Modifier to a strange item of your choice will allow it to also count the number of enemies you've killed with Tornado as Invoker."
"DOTA_Item_Blood_Seekers_Blade"	"Bloodseeker の刃"
"[english]DOTA_Item_Blood_Seekers_Blade"	"Blood Seeker's Blade"
"DOTA_Item_Blood_Seekers_Blade__OffHand"	"Bloodseeker の刃- 左手"
"[english]DOTA_Item_Blood_Seekers_Blade__OffHand"	"Blood Seeker's Blade - Off-Hand"
"DOTA_Item_Desc_KotL_Weapon"	""
"[english]DOTA_Item_Desc_KotL_Weapon"	""
"DOTA_Item_Blood_Seekers_Skirt"	"Bloodseeker のスカート"
"[english]DOTA_Item_Blood_Seekers_Skirt"	"Blood Seeker's Skirt"
"DOTA_Item_Dazzles_mohawk"	"Dazzles の髪型"
"[english]DOTA_Item_Dazzles_mohawk"	"Dazzles mohawk"
"DOTA_Item_Dazzles_staff"	"Dazzles の杖"
"[english]DOTA_Item_Dazzles_staff"	"Dazzles staff"
"DOTA_Item_Dazzles_dress"	"Dazzles の服装"
"[english]DOTA_Item_Dazzles_dress"	"Dazzles dress"
"DOTA_Item_Dazzles_sleeve"	"Dazzles の袖"
"[english]DOTA_Item_Dazzles_sleeve"	"Dazzles sleeve"
"DOTA_Item_Bonehunter_Bracers"	"Bonehunter の籠手"
"[english]DOTA_Item_Bonehunter_Bracers"	"Bonehunter Bracers"
"DOTA_Item_Bonehunter_Tuskguard"	"Bonehunter Tuskguard"
"[english]DOTA_Item_Bonehunter_Tuskguard"	"Bonehunter Tuskguard"
"DOTA_Item_Strange_Modifier_Sven_DoubleStuns"	"ストレンジモディファイア： Storm Hammers で複数ヒーロー攻撃"
"[english]DOTA_Item_Strange_Modifier_Sven_DoubleStuns"	"Strange Modifier: Multi-Hero Storm Hammers"
"DOTA_Item_Desc_Strange_Modifier_Sven_DoubleStuns"	"選択したストレンジアイテムにこのストレンジモディファイアを追加することによって、Sven が着用している間に Storm Hammers で少なくとも二人の敵ヒーローを攻撃した回数がカウントされます。"
"[english]DOTA_Item_Desc_Strange_Modifier_Sven_DoubleStuns"	"Adding this Strange Modifier to a strange item of your choice will allow it to also count the number of your Storm Hammers that hit at least two enemy Heroes while wearing it as Sven."
"DOTA_Item_Strange_Modifier_Sven_WarcryAssists"	"ストレンジモディファイア： Warcry アシスト"
"[english]DOTA_Item_Strange_Modifier_Sven_WarcryAssists"	"Strange Modifier: Warcry Assists"
"DOTA_Item_Desc_Strange_Modifier_Sven_WarcryAssists"	"選択したストレンジアイテムにこのストレンジモディファイアを追加することによって、Sven が着用している間に Warcry 効果を受けた仲間によって倒された敵ヒーローの数がカウントされます。"
"[english]DOTA_Item_Desc_Strange_Modifier_Sven_WarcryAssists"	"Adding this Strange Modifier to a strange item of your choice will allow it to also count the number of enemy Heroes your Warcry-buffed allies kill while wearing it as Sven."
"DOTA_Item_Strange_Modifier_Sven_CleaveDoubleKills"	"ストレンジモディファイア：Cleave での複数ヒーローキル"
"[english]DOTA_Item_Strange_Modifier_Sven_CleaveDoubleKills"	"Strange Modifier: Multi-Hero Cleave Kills"
"DOTA_Item_Desc_Strange_Modifier_Sven_CleaveDoubleKills"	"選択したストレンジアイテムにこのストレンジモディファイアを追加することによって、Sven が着用している間に Cleave　一撃で 複数の敵を倒した回数がカウントされます。"
"[english]DOTA_Item_Desc_Strange_Modifier_Sven_CleaveDoubleKills"	"Adding this Strange Modifier to a strange item of your choice will allow it to also count the number of times a single Cleave kills multiple enemy Heroes while wearing it as Sven."
"DOTA_Item_Strange_Modifier_Sven_TeleportInterrupts"	"ストレンジモディファイア： Storm Hammer でテレポート中断"
"[english]DOTA_Item_Strange_Modifier_Sven_TeleportInterrupts"	"Strange Modifier: Storm Hammer Teleport Interrupts"
"DOTA_Item_Desc_Strange_Modifier_Sven_TeleportInterrupts"	"選択したストレンジアイテムにこのストレンジモディファイアを追加することによって、Sven が着用している間に Storm Hammers で敵ヒーローのテレポートを中断させた回数がカウントされます。"
"[english]DOTA_Item_Desc_Strange_Modifier_Sven_TeleportInterrupts"	"Adding this Strange Modifier to a strange item of your choice will allow it to also count the number of times your Storm Hammer interrupts an enemy Hero's teleport while wearing it as Sven."
"DOTA_Bundle_Bloodseeker_Hlotl"	"Ritual Garb of the Seeker セット"
"[english]DOTA_Bundle_Bloodseeker_Hlotl"	"Ritual Garb of the Seeker Set"
"DOTA_Bundle_Desc_Bloodseeker_Hlotl"	"Bloodseeker 用の 'Ritual Garb of the Seeker' セットに含まれる全てのアイテム:"
"[english]DOTA_Bundle_Desc_Bloodseeker_Hlotl"	"Includes all of the items in the 'Ritual Garb of the Seeker' set for Bloodseeker:"
"DOTA_Bundle_Desc_Ursa_Iron_Bear"	"Ursa 用の 'The Iron Bear' セットに含まれる全てのアイテム:"
"[english]DOTA_Bundle_Desc_Ursa_Iron_Bear"	"Includes all of the items in the 'The Iron Bear' set for Ursa:"
"DOTA_Bundle_Desc_Ursa_Ravager"	"Ursa 用の 'The Ursine Ravager' セットに含まれる全てのアイテム:"
"[english]DOTA_Bundle_Desc_Ursa_Ravager"	"Includes all of the items in the 'The Ursine Ravager' set for Ursa:"
"DOTA_Bundle_Desc_Ursa_Savage_Age"	"Ursa 用の 'The Savage Age' セットに含まれる全てのアイテム:"
"[english]DOTA_Bundle_Desc_Ursa_Savage_Age"	"Includes all of the items in the 'The Savage Age' set for Ursa:"
"DOTA_Bundle_Desc_Bounty_Hunter_Master_Assassin"	"Bounty Hunter 用の 'The Master Assassin' セットに含まれる全てのアイテム:"
"[english]DOTA_Bundle_Desc_Bounty_Hunter_Master_Assassin"	"Includes all of the items in the 'The Master Assassin' set for Bounty Hunter:"
"DOTA_Bundle_Desc_Omniknight_Hierophant"	"Omniknight 用の 'The Hierophant's Protection' セットに含まれる全てのアイテム:"
"[english]DOTA_Bundle_Desc_Omniknight_Hierophant"	"Includes all of the items in the 'The Hierophant's Protection' set for Omniknight:"
"DOTA_Bundle_Desc_Bloodseeker_Bonehunter"	"Bloodseeker 用の 'The Bonehunter' セットに含まれる全てのアイテム:"
"[english]DOTA_Bundle_Desc_Bloodseeker_Bonehunter"	"Includes all of the items in the 'The Bonehunter' set for Bloodseeker:"
"DOTA_Item_Desc_Treasure_Chest_International_2012"	"この宝箱を開けるには<font color='#9da1a9'>International 宝箱の鍵</font> が必要です。DOTA 2 ストアで購入可能です。このチェスとは2012年9月3日に消えてしまします。この宝箱に入っているアンユージュアルクーリエは、International 開催中のみドロップされます。"
"[english]DOTA_Item_Desc_Treasure_Chest_International_2012"	"You will need an <font color='#9da1a9'>International Treasure Key</font> to open this chest. You can pick one up at the DOTA 2 Store. This chest will disappear at the end of September 3rd, 2012. The unusual couriers that may drop from this chest can only be found during the International."
"DOTA_Item_Death_Prophets_Hair"	"Death Prophet の髪型"
"[english]DOTA_Item_Death_Prophets_Hair"	"Death Prophet's Hair"
"DOTA_Item_Death_Prophets_Corset"	"Death Prophet のコルセット"
"[english]DOTA_Item_Death_Prophets_Corset"	"Death Prophet's Corset"
"DOTA_Item_Pudges_Bracer"	"Pudge の籠手"
"[english]DOTA_Item_Pudges_Bracer"	"Pudge's Bracer"
"DOTA_Item_Huskars_Bracer"	"Huskar の籠手"
"[english]DOTA_Item_Huskars_Bracer"	"Huskar's Bracer"
"DOTA_WearableType_Hood_and_Hair"	"頭巾と髪型"
"[english]DOTA_WearableType_Hood_and_Hair"	"Hood and Hair"
"DOTA_WearableType_Paired_Weapons"	"対になった武器"
"[english]DOTA_WearableType_Paired_Weapons"	"Paired Weapons"
"DOTA_Item_Juggernauts_Weapon"	"Juggernaut の武器"
"[english]DOTA_Item_Juggernauts_Weapon"	"Juggernaut's Weapon"
"DOTA_Item_Juggernauts_Cape"	"Juggernaut の肩マント"
"[english]DOTA_Item_Juggernauts_Cape"	"Juggernaut's Cape"
"DOTA_Item_Juggernauts_Bracers"	"Juggernaut の籠手"
"[english]DOTA_Item_Juggernauts_Bracers"	"Juggernaut's Bracers"
"DOTA_Item_AntiMages_Armor"	"Anti-Mage のアーマー"
"[english]DOTA_Item_AntiMages_Armor"	"Anti-Mage's Armor"
"DOTA_Item_Desc_Copy_of_Naga_Sirens_Sword"	"この新しいアイテムには説明がありません。"
"[english]DOTA_Item_Desc_Copy_of_Naga_Sirens_Sword"	"This new item has no description."
"DOTA_Item_Beastmasters_Weapons"	"Beastmaster の武器"
"[english]DOTA_Item_Beastmasters_Weapons"	"Beastmaster's Weapons"
"DOTA_Item_Beastmasterss_Head"	"Beastmasters の頭部"
"[english]DOTA_Item_Beastmasterss_Head"	"Beastmasters's Head"
"DOTA_Item_Beastmasters_Shoulder"	"Beastmaster の肩部"
"[english]DOTA_Item_Beastmasters_Shoulder"	"Beastmaster's Shoulder"
"DOTA_Item_Beastmasters_Arms"	"Beastmaster の腕部"
"[english]DOTA_Item_Beastmasters_Arms"	"Beastmaster's Arms"
"DOTA_Item_Beastmasters_Belt"	"Beastmaster のベルト"
"[english]DOTA_Item_Beastmasters_Belt"	"Beastmaster's Belt"
"DOTA_Item_Linas_Hair"	"Lina の髪型"
"[english]DOTA_Item_Linas_Hair"	"Lina's Hair"
"DOTA_Item_Desc_Linas_Hair"	"Lina の髪型（初期設定）"
"[english]DOTA_Item_Desc_Linas_Hair"	"Lina's default haircut"
"DOTA_Item_Magnuss_Hair"	"Magnus の毛"
"[english]DOTA_Item_Magnuss_Hair"	"Magnus's Hair"
"DOTA_Item_Magnuss_Horn"	"Magnus の角"
"[english]DOTA_Item_Magnuss_Horn"	"Magnus's Horn"
"DOTA_Item_Magnuss_Bracers"	"Magnus の篭手"
"[english]DOTA_Item_Magnuss_Bracers"	"Magnus's Bracers"
"DOTA_Item_Magnuss_Belt"	"Magnus のベルト"
"[english]DOTA_Item_Magnuss_Belt"	"Magnus's Belt"
"DOTA_Item_Magnuss_Weapon"	"Magnus の武器"
"[english]DOTA_Item_Magnuss_Weapon"	"Magnus's Weapon"
"DOTA_Item_Lichs_bracers"	"Lichs の籠手"
"[english]DOTA_Item_Lichs_bracers"	"Lichs bracers"
"DOTA_Item_Direstone_Bracers"	"Direstone の籠手"
"[english]DOTA_Item_Direstone_Bracers"	"Direstone Bracers"
"DOTA_Item_Captains_Compass_set"	"Captain's Compass (セット）"
"[english]DOTA_Item_Captains_Compass_set"	"Captain's Compass (set)"
"DOTA_Item_Barrel_Quiver"	"酒樽の矢筒"
"[english]DOTA_Item_Barrel_Quiver"	"Barrel Quiver"
"DOTA_Item_Kunkkas_Coral_Sword"	"Kunkka's Coral Sword"
"[english]DOTA_Item_Kunkkas_Coral_Sword"	"Kunkka's Coral Sword"
"DOTA_Item_Khan_Gaunlet_set"	"Khan Gaunlet （セット）"
"[english]DOTA_Item_Khan_Gaunlet_set"	"Khan Gaunlet (set)"
"DOTA_Item_Captains_Gold_set"	"Captain's Gold (セット）"
"[english]DOTA_Item_Captains_Gold_set"	"Captain's Gold (set)"
"DOTA_Item_Captains_Treasuremap_set"	"Captain's Treasuremap (セット）"
"[english]DOTA_Item_Captains_Treasuremap_set"	"Captain's Treasuremap (set)"
"DOTA_Item_Kunkkas_Shadowblade"	"Kunkka's Shadowblade"
"[english]DOTA_Item_Kunkkas_Shadowblade"	"Kunkka's Shadowblade"
"DOTA_Item_Brother_Omnis_Piety_set"	"Brother Omni's Piety (セット）"
"[english]DOTA_Item_Brother_Omnis_Piety_set"	"Brother Omni's Piety (set)"
"DOTA_Item_Brother_Omnis_Forgiveness_set"	"Brother Omni's Forgiveness (セット）"
"[english]DOTA_Item_Brother_Omnis_Forgiveness_set"	"Brother Omni's Forgiveness (set)"
"DOTA_Item_Brother_Omnis_Vigor_set"	"Brother Omni's Vigor (セット）"
"[english]DOTA_Item_Brother_Omnis_Vigor_set"	"Brother Omni's Vigor (set)"
"DOTA_Item_Brother_Omnis_Devotion_set"	"Brother Omni's Devotion (セット）"
"[english]DOTA_Item_Brother_Omnis_Devotion_set"	"Brother Omni's Devotion (set)"
"DOTA_Item_Brother_Omnis_Benevolence_set"	"Brother Omni's Benevolence (セット）"
"[english]DOTA_Item_Brother_Omnis_Benevolence_set"	"Brother Omni's Benevolence (set)"
"DOTA_Item_Brother_Omnis_Justice_set"	"Brother Omni's Justice (セット）"
"[english]DOTA_Item_Brother_Omnis_Justice_set"	"Brother Omni's Justice (set)"
"DOTA_Item_Winged_Paladins_Gauntlet"	"Winged Paladin の篭手"
"[english]DOTA_Item_Winged_Paladins_Gauntlet"	"Winged Paladin's Gauntlet"
"DOTA_Item_Khan_Cape_set"	"Khan の肩マント （セット）"
"[english]DOTA_Item_Khan_Cape_set"	"Khan Cape (set)"
"DOTA_Item_Zarukina_Protector_Hair"	"Zaru'kina Protector の髪型"
"[english]DOTA_Item_Zarukina_Protector_Hair"	"Zaru'kina Protector Hair"
"DOTA_Item_Captains_Shovel_set"	"Captains Shovel (セット）"
"[english]DOTA_Item_Captains_Shovel_set"	"Captains Shovel (set)"
"DOTA_Item_Khan_Crown_set"	"Khan Crown （セット）"
"[english]DOTA_Item_Khan_Crown_set"	"Khan Crown (set)"
"DOTA_Item_Khan_Pauldrons_set"	"Khan Pauldrons （セット）"
"[english]DOTA_Item_Khan_Pauldrons_set"	"Khan Pauldrons (set)"
"DOTA_Item_Kunkkas_Spiced_Rum"	"Kunkka's Spiced Rum"
"[english]DOTA_Item_Kunkkas_Spiced_Rum"	"Kunkka's Spiced Rum"
"DOTA_Item_Dark_Quiver_of_the_Vandal"	"Dark Quiver of the Vandal"
"[english]DOTA_Item_Dark_Quiver_of_the_Vandal"	"Dark Quiver of the Vandal"
"DOTA_Item_Sparrowhawk_Cape"	"Sparrowhawk の肩マント"
"[english]DOTA_Item_Sparrowhawk_Cape"	"Sparrowhawk Cape"
"DOTA_Item_Sparrowhawk_Quiver"	"Sparrowhawk の矢筒"
"[english]DOTA_Item_Sparrowhawk_Quiver"	"Sparrowhawk Quiver"
"DOTA_Item_Desc_the_evildoer"	"この新しいアイテムには説明がありません。"
"[english]DOTA_Item_Desc_the_evildoer"	"This new item has no description."
"DOTA_Item_Sylvan_Guards_Cape"	"Sylvan Guard の肩マント"
"[english]DOTA_Item_Sylvan_Guards_Cape"	"Sylvan Guard's Cape"
"DOTA_Item_Sylvan_Guards_Hair"	"Sylvan Guard の髪型"
"[english]DOTA_Item_Sylvan_Guards_Hair"	"Sylvan Guard's Hair"
"DOTA_Item_Sylvan_Guards_Quiver"	"Sylvan Guard の矢筒"
"[english]DOTA_Item_Sylvan_Guards_Quiver"	"Sylvan Guard's Quiver"
"DOTA_Item_Desc_Mysterious_Egg"	"硬く、鱗があり、正に孵化しようとしている卵。Diretide エッセンスの中に含まれた魔法のエネルギーに飢えている。 何が産まれてくるかは、卵が消費した魔法の種類や量によって決定される。"
"[english]DOTA_Item_Desc_Mysterious_Egg"	"A hard, scaled egg that seems to be alive and almost ready to hatch. It hungers for the magical energies contained in Diretide essences. What comes out will be determined by the type and amount of magic the egg consumes."
"DOTA_Item_Desc_Portal_2_Soundtrack_Gift_Pack"	"Portal 2 soundtrackを購入したためプレゼントされました! このギフトを開封するためにダブルクリックしてください。"
"[english]DOTA_Item_Desc_Portal_2_Soundtrack_Gift_Pack"	"A gift for your purchase of the Portal 2 soundtrack! Double click this gift to unwrap it."
"DOTA_Item_Strange_Modifier_Faceless_MultiChrono"	"ストレンジモディファイア： 複数ヒーロー Chronospheres"
"[english]DOTA_Item_Strange_Modifier_Faceless_MultiChrono"	"Strange Modifier: Multi-Hero Chronospheres"
"DOTA_Item_Desc_Strange_Modifier_Faceless_MultiChrono"	"選択したストレンジアイテムにこのストレンジモディファイアを追加することによって、Faceless Void が着用している間に少なくとも二人の敵ヒーローを攻撃した Chronosphere の数がカウントされます。"
"[english]DOTA_Item_Desc_Strange_Modifier_Faceless_MultiChrono"	"Adding this Strange Modifier to a strange item of your choice will allow it to also count the number of your Chronospheres that hit at least two enemy Heroes while wearing it as Faceless Void."
"DOTA_Item_Strange_Modifier_Faceless_ChronoKills"	"ストレンジモディファイア： Chronosphere キル"
"[english]DOTA_Item_Strange_Modifier_Faceless_ChronoKills"	"Strange Modifier: Chronosphere Kills"
"DOTA_Item_Desc_Strange_Modifier_Faceless_ChronoKills"	"選択したストレンジアイテムにこのストレンジモディファイアを追加することによって、Faceless Void が着用している間に　Chronospheres　の中で殺した敵の数がカウントされます。"
"[english]DOTA_Item_Desc_Strange_Modifier_Faceless_ChronoKills"	"Adding this Strange Modifier to a strange item of your choice will allow it to also count the number of enemy Heroes you've killed inside your Chronospheres while wearing it as Faceless Void."
"DOTA_Item_Strange_Modifier_Ursa_MultiShocks"	"ストレンジモディファイア：複数ヒーローへ Earthshocks"
"[english]DOTA_Item_Strange_Modifier_Ursa_MultiShocks"	"Strange Modifier: Multi-Hero Earthshocks"
"DOTA_Item_Desc_Strange_Modifier_Ursa_MultiShocks"	"選択したストレンジアイテムにこのストレンジモディファイアを追加することによって、Ursa が着用している間に少なくとも二人の敵ヒーローを攻撃した Earthshocks の回数がカウントされます。"
"[english]DOTA_Item_Desc_Strange_Modifier_Ursa_MultiShocks"	"Adding this Strange Modifier to a strange item of your choice will allow it to also count the number of your Earthshocks that hit at least two enemy Heroes while wearing it as Ursa."
"DOTA_Item_Strange_Modifier_RoshanKills"	"ストレンジモディファイア：Roshan キル"
"[english]DOTA_Item_Strange_Modifier_RoshanKills"	"Strange Modifier: Roshan Kills"
"DOTA_Item_Desc_Strange_Modifier_RoshanKills"	"選択したストレンジアイテムにこのストレンジモディファイアを追加することによって、着用している間に Roshan を倒した回数がカウントされます。"
"[english]DOTA_Item_Desc_Strange_Modifier_RoshanKills"	"Adding this Strange Modifier to a strange item of your choice will allow it to also count the number of times you've killed Roshan while wearing it."
"DOTA_Item_Heartwood_Vanguard_Set"	"Heartwood Vanguard セット"
"[english]DOTA_Item_Heartwood_Vanguard_Set"	"Heartwood Vanguard Set"
"DOTA_Item_Garments_of_the_PeaceBringer_Set"	"Garments of the Peace-Bringer セット"
"[english]DOTA_Item_Garments_of_the_PeaceBringer_Set"	"Garments of the Peace-Bringer Set"
"DOTA_Item_Master_of_Beast_and_Bole_Set"	"Master of Beast and Bole （セット）"
"[english]DOTA_Item_Master_of_Beast_and_Bole_Set"	"Master of Beast and Bole Set"
"DOTA_Item_The_Axecutioner_Set"	"The Axecutioner セット"
"[english]DOTA_Item_The_Axecutioner_Set"	"The Axecutioner Set"
"DOTA_Item_Swordmaster_of_the_Vigil_Set"	"Swordmaster of the Vigil セット"
"[english]DOTA_Item_Swordmaster_of_the_Vigil_Set"	"Swordmaster of the Vigil Set"
"DOTA_Item_Mono_Militis_Set"	"Mono Militis セット"
"[english]DOTA_Item_Mono_Militis_Set"	"Mono Militis Set"
"DOTA_Item_Flameguard_Set"	"Flameguard セット"
"[english]DOTA_Item_Flameguard_Set"	"Flameguard Set"
"DOTA_Item_The_Alpine_Stalkers_Set"	"The Alpine Stalker's セット"
"[english]DOTA_Item_The_Alpine_Stalkers_Set"	"The Alpine Stalker's Set"
"DOTA_Bundle_Desc_Ursa_Alpine_Stalker"	"Ursa 用の 'The Alpine Stalker' セットに含まれる全てのアイテム:"
"[english]DOTA_Bundle_Desc_Ursa_Alpine_Stalker"	"Includes all of the items in the 'The Alpine Stalker' set for Ursa:"
"DOTA_Item_Saberhorns_Armor_Set"	"Saberhorn's Armor セット"
"[english]DOTA_Item_Saberhorns_Armor_Set"	"Saberhorn's Armor Set"
"DOTA_Item_Desc_Armor_of_the_Saberhorn_Set"	"Axe 用の 'Armor of the Saberhorn' セットに含まれる全てのアイテム:"
"[english]DOTA_Item_Desc_Armor_of_the_Saberhorn_Set"	"Includes all of the items in the 'Armor of the Saberhorn' set for Axe:"
"DOTA_Item_Heavy_Steel_Armor_Set"	"Heavy Steel Armor セット"
"[english]DOTA_Item_Heavy_Steel_Armor_Set"	"Heavy Steel Armor Set"
"DOTA_Item_Demonic_Vandals_Set"	"Demonic Vandal セット"
"[english]DOTA_Item_Demonic_Vandals_Set"	"Demonic Vandal's Set"
"DOTA_Item_Desc_Demonic_Vandals_Set"	"Clinkz 用の 'Demonic Vandal's' セットに含まれる全てのアイテム:"
"[english]DOTA_Item_Desc_Demonic_Vandals_Set"	"Includes all of the items in the 'Demonic Vandal's' set for Clinkz:"
"DOTA_Item_Dials_of_Claszureme_Set"	"Dials of Claszureme セット"
"[english]DOTA_Item_Dials_of_Claszureme_Set"	"Dials of Claszureme Set"
"DOTA_Item_Desc_Dials_of_Claszureme_Set"	"Faceless Void 用の 'Dials of Claszureme' セットに含まれる全てのアイテム:"
"[english]DOTA_Item_Desc_Dials_of_Claszureme_Set"	"Includes all of the items in the 'Dials of Claszureme' set for Faceless Void:"
"DOTA_Item_Kunkkas_But_Im_Not_A_Pirate_Pack"	"Kunkka の 'But I'm Not A Pirate!' パック"
"[english]DOTA_Item_Kunkkas_But_Im_Not_A_Pirate_Pack"	"Kunkka's 'But I'm Not A Pirate!' Pack"
"DOTA_Item_Shards_of_Polymorphia_Set"	"Shards of Polymorphia セット"
"[english]DOTA_Item_Shards_of_Polymorphia_Set"	"Shards of Polymorphia Set"
"DOTA_Item_Desc_Shards_of_Polymorphia_Set"	"Morphling 用の 'Shards of Polymorphia' セットに含まれる全てのアイテム:"
"[english]DOTA_Item_Desc_Shards_of_Polymorphia_Set"	"Includes all of the items in the 'Shards of Polymorphia' set for Morphling:"
"DOTA_Item_Bindings_of_Frost_Set"	"Bindings of Frost セット"
"[english]DOTA_Item_Bindings_of_Frost_Set"	"Bindings of Frost Set"
"DOTA_Item_Desc_Bindings_of_Frost_Set"	"Morphling 用の 'Bindings of Frost' セットに含まれる全てのアイテム:"
"[english]DOTA_Item_Desc_Bindings_of_Frost_Set"	"Includes all of the items in the 'Bindings of Frost' set for Morphling:"
"DOTA_Item_Birots_Bindings_Set"	"Birot's Bindings セット"
"[english]DOTA_Item_Birots_Bindings_Set"	"Birot's Bindings Set"
"DOTA_Item_Desc_Birots_Bindings_Set"	"Morphling 用の 'Birot's Bindings' セットに含まれる全てのアイテム:"
"[english]DOTA_Item_Desc_Birots_Bindings_Set"	"Includes all of the items in the 'Birot's Bindings' set for Morphling:"
"DOTA_Item_Shards_of_the_Falling_Comet_Set"	"Shards of the Falling Comet セット"
"[english]DOTA_Item_Shards_of_the_Falling_Comet_Set"	"Shards of the Falling Comet Set"
"DOTA_Item_Desc_Shards_of_the_Falling_Comet"	"Morphling 用の 'Shards of the Falling Comet' セットに含まれる全てのアイテム:"
"[english]DOTA_Item_Desc_Shards_of_the_Falling_Comet"	"Includes all of the items in the 'Shards of the Falling Comet' set for Morphling:"
"DOTA_Item_Desc_The_Crimson_Cutthroat_Set"	"Bounty Hunter 用の 'The Crimson Cut-throat' セットに含まれる全てのアイテム:"
"[english]DOTA_Item_Desc_The_Crimson_Cutthroat_Set"	"Includes all of the items in the 'The Crimson Cut-throat' set for Bounty Hunter:"
"DOTA_Item_Bones_of_the_Slain_Dragon_Set"	"Bones of the Slain Dragon セット"
"[english]DOTA_Item_Bones_of_the_Slain_Dragon_Set"	"Bones of the Slain Dragon Set"
"DOTA_Item_Desc_Bones_of_the_Slain_Dragon_Set"	"Dragon Knight 用の 'Bones of the Slain Dragon' セットに含まれる全てのアイテム:"
"[english]DOTA_Item_Desc_Bones_of_the_Slain_Dragon_Set"	"Includes all of the items in the 'Bones of the Slain Dragon' set for Dragon Knight:"
"DOTA_Item_FireBlessed_Mail_of_the_Drake_Set"	"Fire-Blessed Mail of the Drake セット"
"[english]DOTA_Item_FireBlessed_Mail_of_the_Drake_Set"	"Fire-Blessed Mail of the Drake Set"
"DOTA_Item_Desc_FireBlessed_Mail_of_the_Drake"	"Dragon Knight 用の 'Fire-Blessed Mail of the Drake' セットに含まれる全てのアイテム:"
"[english]DOTA_Item_Desc_FireBlessed_Mail_of_the_Drake"	"Includes all of the items in the 'Fire-Blessed Mail of the Drake' set for Dragon Knight:"
"DOTA_Item_Enchanted_Plate_of_the_Crimson_Wyvern_Set"	"Enchanted Plate of the Crimson Wyvern セット"
"[english]DOTA_Item_Enchanted_Plate_of_the_Crimson_Wyvern_Set"	"Enchanted Plate of the Crimson Wyvern Set"
"DOTA_Item_Desc_Enchanted_Plate_of_the_Crimson_Wyvern_Set"	"Dragon Knight 用の 'Enchanted Plate of the Crimson Wyvern' セットに含まれる全てのアイテム:"
"[english]DOTA_Item_Desc_Enchanted_Plate_of_the_Crimson_Wyvern_Set"	"Includes all of the items in the 'Enchanted Plate of the Crimson Wyvern' set for Dragon Knight:"
"DOTA_Item_Honors_of_the_Golden_Mane_Set"	"Honors of the Golden Mane セット"
"[english]DOTA_Item_Honors_of_the_Golden_Mane_Set"	"Honors of the Golden Mane Set"
"DOTA_Item_Desc_Arms_of_the_Golden_Mane"	"Phantom Lancer 用の 'Arms of the Golden Mane' セットに含まれる全てのアイテム:"
"[english]DOTA_Item_Desc_Arms_of_the_Golden_Mane"	"Includes all of the items in the 'Arms of the Golden Mane' set for Phantom Lancer:"
"DOTA_Item_Revered_Arms_Set"	"Revered Arms セット"
"[english]DOTA_Item_Revered_Arms_Set"	"Revered Arms Set"
"DOTA_Item_Desc_Kinship_Arms"	"Phantom Lancer 用の 'Revered Arms' セットに含まれる全てのアイテム:"
"[english]DOTA_Item_Desc_Kinship_Arms"	"Includes all of the items in the 'Revered Arms' set for Phantom Lancer:"
"DOTA_Item_Armor_of_Renewed_Faith_Set"	"Armor of Renewed Faith セット"
"[english]DOTA_Item_Armor_of_Renewed_Faith_Set"	"Armor of Renewed Faith Set"
"DOTA_Item_Desc_Armor_of_Renewed_Faith_Set"	"Omniknight 用の 'Armor of Renewed Faith' セットに含まれる全てのアイテム:"
"[english]DOTA_Item_Desc_Armor_of_Renewed_Faith_Set"	"Includes all of the items in the 'Armor of Renewed Faith' set for Omniknight:"
"DOTA_Item_Desc_Thunderwraths_Calling_Set"	"Omniknight 用の 'Thunderwrath's Calling' セットに含まれる全てのアイテム:"
"[english]DOTA_Item_Desc_Thunderwraths_Calling_Set"	"Includes all of the items in the 'Thunderwrath's Calling' set for Omniknight:"
"DOTA_Item_Desc_Wings_of_the_Paladin"	"Omniknight 用の 'Wings of the Paladin' セットに含まれる全てのアイテム:"
"[english]DOTA_Item_Desc_Wings_of_the_Paladin"	"Includes all of the items in the 'Wings of the Paladin' set for Omniknight:"
"DOTA_Item_Falconers_Design_Set"	"Falconer's Design セット"
"[english]DOTA_Item_Falconers_Design_Set"	"Falconer's Design Set"
"DOTA_Item_Desc_Falconers_Design_Set"	"Windrunner 用の 'Falconer's Design' セットに含まれる全てのアイテム:"
"[english]DOTA_Item_Desc_Falconers_Design_Set"	"Includes all of the items in the 'Falconer's Design' set for Windranger:"
"DOTA_Item_Flight_of_the_Sparrowhawk_Set"	"Flight of the Sparrowhawk セット"
"[english]DOTA_Item_Flight_of_the_Sparrowhawk_Set"	"Flight of the Sparrowhawk Set"
"DOTA_Item_Sylvan_Guards_Finery_Set"	"Sylvan Guard's Finery セット"
"[english]DOTA_Item_Sylvan_Guards_Finery_Set"	"Sylvan Guard's Finery Set"
"DOTA_Set_Bloodseeker_Hlotl"	"Ritual Garb of the Seeker"
"[english]DOTA_Set_Bloodseeker_Hlotl"	"Ritual Garb of the Seeker"
"DOTA_Set_Bloodseeker_Bonehunter"	"The Bonehunter"
"[english]DOTA_Set_Bloodseeker_Bonehunter"	"The Bonehunter"
"DOTA_Set_Clinkz_Vandal"	"Demonic Vandal"
"[english]DOTA_Set_Clinkz_Vandal"	"The Demonic Vandal"
"DOTA_Set_Drow_Ranger_Frost_Spikes"	"Spikes of Frost"
"[english]DOTA_Set_Drow_Ranger_Frost_Spikes"	"Spikes of Frost"
"DOTA_Set_Furion_Heartwood_Vanguard"	"Heartwood Vanguard"
"[english]DOTA_Set_Furion_Heartwood_Vanguard"	"Heartwood Vanguard"
"DOTA_Set_Invoker_Exort"	"Exort の炎"
"[english]DOTA_Set_Invoker_Exort"	"The Fires of Exort"
"DOTA_Set_Invoker_Magus_Magnus"	"The Magus Magnus"
"[english]DOTA_Set_Invoker_Magus_Magnus"	"The Magus Magnus"
"DOTA_Set_Kunkka_Admirable_Admiral"	"The Admirable Admiral"
"[english]DOTA_Set_Kunkka_Admirable_Admiral"	"The Admirable Admiral"
"DOTA_Set_Tidehunter_Pirate_Slayer"	"Pirate's Booty"
"[english]DOTA_Set_Tidehunter_Pirate_Slayer"	"The Pirate's Booty"
"DOTA_Set_Tidehunter_Punisher"	"Paleogeneous Punisher"
"[english]DOTA_Set_Tidehunter_Punisher"	"The Paleogeneous Punisher"
"DOTA_Item_AntiMages_Glaive"	"Anti-Mage の剣"
"[english]DOTA_Item_AntiMages_Glaive"	"Anti-Mage's Glaive"
"DOTA_Item_Doombringers_Weapon"	"Doombringer の武器"
"[english]DOTA_Item_Doombringers_Weapon"	"Doombringer's Weapon"
"DOTA_Item_Doombringers_Shoulder_Armor"	"Doombringer の肩鎧"
"[english]DOTA_Item_Doombringers_Shoulder_Armor"	"Doombringer's Shoulder Armor"
"DOTA_Item_Doombringers_Bracers"	"Doombringer の籠手"
"[english]DOTA_Item_Doombringers_Bracers"	"Doombringer's Bracers"
"DOTA_Item_AntiMages_Offhand_Glaive"	"Anti-Mage 逆腕用の剣"
"[english]DOTA_Item_AntiMages_Offhand_Glaive"	"Anti-Mage's Offhand Glaive"
"DOTA_Item_Leshracs_Arms"	"Leshrac の腕部"
"[english]DOTA_Item_Leshracs_Arms"	"Leshrac's Arms"
"DOTA_Item_Desc_Copy_of_Nightstalkers_Wings"	"この新しいアイテムには説明がありません。"
"[english]DOTA_Item_Desc_Copy_of_Nightstalkers_Wings"	"This new item has no description."
"DOTA_Item_Desc_Copy_of_Nightstalkers_Armor"	"この新しいアイテムには説明がありません。"
"[english]DOTA_Item_Desc_Copy_of_Nightstalkers_Armor"	"This new item has no description."
"DOTA_Item_Razors_Weapon"	"Razor の武器"
"[english]DOTA_Item_Razors_Weapon"	"Razor's Weapon"
"DOTA_Item_Razors_Head"	"Razor の頭部"
"[english]DOTA_Item_Razors_Head"	"Razor's Head"
"DOTA_Item_Razors_Bracers"	"Razor の籠手"
"[english]DOTA_Item_Razors_Bracers"	"Razor's Bracers"
"DOTA_Item_Leshracs_Head"	"Leshrac の頭部"
"[english]DOTA_Item_Leshracs_Head"	"Leshrac's Head"
"DOTA_Item_AntiMage_Slasher_Offhand_Weapon"	"Anti-Mage Slasher 逆腕用の武器"
"[english]DOTA_Item_AntiMage_Slasher_Offhand_Weapon"	"Anti-Mage Slasher Offhand Weapon"
"DOTA_Item_AntiMage_Slasher_Armor"	"Anti-Mage Slasher Armor"
"[english]DOTA_Item_AntiMage_Slasher_Armor"	"Anti-Mage Slasher Armor"
"DOTA_Item_AntiMage_Slasher_Shoulder"	"Anti-Mage Slasher Shoulder"
"[english]DOTA_Item_AntiMage_Slasher_Shoulder"	"Anti-Mage Slasher Shoulder"
"DOTA_Item_AntiMage_Slasher_Bracer"	"Anti-Mage Slasher Bracer"
"[english]DOTA_Item_AntiMage_Slasher_Bracer"	"Anti-Mage Slasher Bracer"
"DOTA_Item_AntiMage_Slasher_Skirt"	"Anti-Mage Slasher Skirt"
"[english]DOTA_Item_AntiMage_Slasher_Skirt"	"Anti-Mage Slasher Skirt"
"DOTA_Item_AntiMage_Slasher_Weapon"	"Anti-Mage Slasher Weapon"
"[english]DOTA_Item_AntiMage_Slasher_Weapon"	"Anti-Mage Slasher Weapon"
"DOTA_Item_AntiMage_Slasher_Helm"	"Anti-Mage Slasher Helm"
"[english]DOTA_Item_AntiMage_Slasher_Helm"	"Anti-Mage Slasher Helm"
"DOTA_Item_Desc_Exort_Essence"	"混じり気の無い Exort エネルギーを含んだ結晶。身の毛がよだつ程の残忍さの魔法オーラを発散させており、触れられない程の熱さを持つ。"
"[english]DOTA_Item_Desc_Exort_Essence"	"A crystal containing pure Exort energy. The crystal is hot to the touch and exudes a magical aura of gruesome brutality."
"DOTA_Item_Desc_Wex_Essence"	"混じり気の無い Wex エネルギーを含んだ結晶。破片の表面は常に振動しており、生命力あふれる情熱の魔法オーラを発している。"
"[english]DOTA_Item_Desc_Wex_Essence"	"A crystal containing pure Wex energy. The surface of the shard is in constant motion, emitting a magical aura of spirited zeal."
"DOTA_Item_Desc_Quas_Essence"	"混じり気のないQuas エネルギーの結晶。 冷たく重いこの結晶は、頑固な執念の魔法オーラを発する。"
"[english]DOTA_Item_Desc_Quas_Essence"	"A crystal of pure Quas energy. It is cold and heavy, radiating a magical aura of stubborn tenacity."
"DOTA_WearableType_Sexy_Hair"	"セクシーな髪型"
"[english]DOTA_WearableType_Sexy_Hair"	"Sexy Hair"
"DOTA_Item_Kunkkas_Hair"	"Kunkka の髪型"
"[english]DOTA_Item_Kunkkas_Hair"	"Kunkka's Hair"
"DOTA_Item_Slarks_Weapon"	"Slark の武器"
"[english]DOTA_Item_Slarks_Weapon"	"Slark's Weapon"
"DOTA_Item_Desc_Dark_Seers_Spikes"	"この新しいアイテムには説明がありません。"
"[english]DOTA_Item_Desc_Dark_Seers_Spikes"	"This new item has no description."
"DOTA_Item_Desc_Dark_Seers_Hat"	"この新しいアイテムには説明がありません。"
"[english]DOTA_Item_Desc_Dark_Seers_Hat"	"This new item has no description."
"DOTA_Item_Dark_Seers_Bracers"	"Dark Seers の籠手"
"[english]DOTA_Item_Dark_Seers_Bracers"	"Dark Seers Bracers"
"DOTA_Item_Desc_Copy_of_Dark_Seers_Hat"	"この新しいアイテムには説明がありません。"
"[english]DOTA_Item_Desc_Copy_of_Dark_Seers_Hat"	"This new item has no description."
"DOTA_Item_Desc_Dark_Seers_Loin_Cloth"	"この新しいアイテムには説明がありません。"
"[english]DOTA_Item_Desc_Dark_Seers_Loin_Cloth"	"This new item has no description."
"DOTA_Item_Desc_Copy_of_Dark_Seers_Loin_Cloth"	"この新しいアイテムには説明がありません。"
"[english]DOTA_Item_Desc_Copy_of_Dark_Seers_Loin_Cloth"	"This new item has no description."
"DOTA_Item_Slarks_Bracers"	"Slark の籠手"
"[english]DOTA_Item_Slarks_Bracers"	"Slark's Bracers"
"DOTA_Item_Desc_Copy_of_Slarks_Weapon"	"この新しいアイテムには説明がありません。"
"[english]DOTA_Item_Desc_Copy_of_Slarks_Weapon"	"This new item has no description."
"DOTA_Item_Slarks_Shoulder_Armor"	"Slark の肩鎧"
"[english]DOTA_Item_Slarks_Shoulder_Armor"	"Slark's Shoulder Armor"
"DOTA_Item_Desc_Copy_of_Slarks_Bracers"	"この新しいアイテムには説明がありません。"
"[english]DOTA_Item_Desc_Copy_of_Slarks_Bracers"	"This new item has no description."
"DOTA_Item_Slarks_Cape"	"Slark の肩マント"
"[english]DOTA_Item_Slarks_Cape"	"Slark's Cape"
"DOTA_Item_Desc_Copy_of_Slarks_Shoulder_Armor"	"この新しいアイテムには説明がありません。"
"[english]DOTA_Item_Desc_Copy_of_Slarks_Shoulder_Armor"	"This new item has no description."
"DOTA_Item_Desc_Slarks_Hood"	"この新しいアイテムには説明がありません。"
"[english]DOTA_Item_Desc_Slarks_Hood"	"This new item has no description."
"DOTA_Item_Centaurs_Horns_and_Hair"	"Centaur の角と髪型"
"[english]DOTA_Item_Centaurs_Horns_and_Hair"	"Centaur's Horns and Hair"
"DOTA_Item_Desc_Copy_of_Centaurs_Axe"	"この新しいアイテムには説明がありません。"
"[english]DOTA_Item_Desc_Copy_of_Centaurs_Axe"	"This new item has no description."
"DOTA_Item_Desc_Copy_of_Centaurs_Pride"	"この新しいアイテムには説明がありません。"
"[english]DOTA_Item_Desc_Copy_of_Centaurs_Pride"	"This new item has no description."
"DOTA_Item_Desc_Copy_of_Centaurs_Upper_Armor"	"この新しいアイテムには説明がありません。"
"[english]DOTA_Item_Desc_Copy_of_Centaurs_Upper_Armor"	"This new item has no description."
"DOTA_Item_Desc_Copy_of_Centaurs_Belt_Buckle"	"この新しいアイテムには説明がありません。"
"[english]DOTA_Item_Desc_Copy_of_Centaurs_Belt_Buckle"	"This new item has no description."
"DOTA_Item_Centaurs_Bracers"	"Centaur の籠手"
"[english]DOTA_Item_Centaurs_Bracers"	"Centaur's Bracers"
"DOTA_Item_Desc_Copy_of_Centaurs_Trophies"	"この新しいアイテムには説明がありません。"
"[english]DOTA_Item_Desc_Copy_of_Centaurs_Trophies"	"This new item has no description."
"DOTA_Item_Desc_Copy_of_Centaurs_Bracers"	"この新しいアイテムには説明がありません。"
"[english]DOTA_Item_Desc_Copy_of_Centaurs_Bracers"	"This new item has no description."
"DOTA_Item_ZaruKina_Protectors_Cape"	"Zaru'Kina Protector の肩マント"
"[english]DOTA_Item_ZaruKina_Protectors_Cape"	"Zaru'Kina Protector's Cape"
"DOTA_Item_ZaruKina_Protectors_Hair"	"Zaru'Kina Protector の髪型"
"[english]DOTA_Item_ZaruKina_Protectors_Hair"	"Zaru'Kina Protector's Hair"
"DOTA_Item_Desc_Cape_of_the_Dark_Magic"	"Invoker にとって魔法の才能を持たない者は昆虫のようにどうでも良い存在である。というのも、彼の凶暴性は、魔法という芸術が迷信と恐怖と共に扱われる代物だと信じているだからだ。"
"[english]DOTA_Item_Desc_Cape_of_the_Dark_Magic"	"To the Invoker, those without the gifts of magic are insects to be ignored or destroyed.  For at time, his ferocity was such that the magical arts were treated with superstition and fear by all."
"DOTA_Item_Greevil_Hair_1"	"Greevil の毛 1"
"[english]DOTA_Item_Greevil_Hair_1"	"Greevil Hair 1"
"DOTA_Item_Greevil_Hair_2"	"Greevil の毛 2"
"[english]DOTA_Item_Greevil_Hair_2"	"Greevil Hair 2"
"DOTA_Item_Cabalist_of_Dark_Magic_Set"	"Cabalist of Dark Magic (セット）"
"[english]DOTA_Item_Cabalist_of_Dark_Magic_Set"	"Cabalist of Dark Magic Set"
"DOTA_Item_Desc_Cabalist_of_Dark_Magic_Set"	"Invoker 用の 'Cabalist of Dark Magic' セット内の全てのアイテムを含みます："
"[english]DOTA_Item_Desc_Cabalist_of_Dark_Magic_Set"	"Includes all of the items in the 'Cabalist of Dark Magic' set for Invoker:"
"DOTA_Item_Lions_Default_Weapon"	"Lion の武器（ディフォルト）"
"[english]DOTA_Item_Lions_Default_Weapon"	"Lion's Default Weapon"
"DOTA_Item_Desc_Lions_Default_Weapon"	"この新しいアイテムには説明がありません。"
"[english]DOTA_Item_Desc_Lions_Default_Weapon"	"This new item has no description."
"DOTA_Item_Lions_Default_cape"	"Lion の肩マント（初期設定）"
"[english]DOTA_Item_Lions_Default_cape"	"Lion's Default cape"
"DOTA_Item_Desc_Copy_of_Lions_Default_Weapon"	"この新しいアイテムには説明がありません。"
"[english]DOTA_Item_Desc_Copy_of_Lions_Default_Weapon"	"This new item has no description."
"DOTA_Item_Desc_Copy_of_Lions_Default_cape"	"この新しいアイテムには説明がありません。"
"[english]DOTA_Item_Desc_Copy_of_Lions_Default_cape"	"This new item has no description."
"DOTA_Item_Desc_Copy_of_Lions_Default_Hat"	"この新しいアイテムには説明がありません。"
"[english]DOTA_Item_Desc_Copy_of_Lions_Default_Hat"	"This new item has no description."
"DOTA_Item_Desc_Copy_of_Lions_Default_Shoulders"	"この新しいアイテムには説明がありません。"
"[english]DOTA_Item_Desc_Copy_of_Lions_Default_Shoulders"	"This new item has no description."
"DOTA_Item_Ghastly_Treasure_of_Diretide"	"Ghastly Treasure of Diretide"
"[english]DOTA_Item_Ghastly_Treasure_of_Diretide"	"Ghastly Treasure of Diretide"
"DOTA_Item_Desc_Treasure_Chest_Diretide_2013"	"この宝箱を開けるには<font color='#9da1a9'>Diretide 宝箱の鍵</font> が必要です。鍵はDOTA 2 ストアで入手できます。この宝箱は2012年11月11日に消えてしまいます。"
"[english]DOTA_Item_Desc_Treasure_Chest_Diretide_2013"	"You will need a <font color='#9da1a9'>Diretide Treasure Key</font> to open this chest. You can pick one up at the DOTA 2 Store."
"DOTA_Item_Treasure_Key_Diretide"	"Diretide 宝箱の鍵"
"[english]DOTA_Item_Treasure_Key_Diretide"	"Diretide Treasure Key"
"DOTA_Item_Desc_Windrunners_Sylvan_Bundle"	"このバンドルには2012年10月にリリースされた Windrunner 用の全てのアイテムが含まれます。"
"[english]DOTA_Item_Desc_Windrunners_Sylvan_Bundle"	"This bundle contains all of the items for Windrunner released in October 2012."
"DOTA_Item_Desc_Copy_of_Pucks_Wings"	"この新しいアイテムには説明がありません。"
"[english]DOTA_Item_Desc_Copy_of_Pucks_Wings"	"This new item has no description."
"DOTA_Item_Desc_Copy_of_Pucks_Tail"	"この新しいアイテムには説明がありません。"
"[english]DOTA_Item_Desc_Copy_of_Pucks_Tail"	"This new item has no description."
"DOTA_Item_troll_warlord_base_weapon"	"troll_warlord_base_weapon"
"[english]DOTA_Item_troll_warlord_base_weapon"	"troll_warlord_base_weapon"
"DOTA_Item_Desc_base_off_hand_ranged_weapon"	"この新しいアイテムには説明がありません。"
"[english]DOTA_Item_Desc_base_off_hand_ranged_weapon"	"This new item has no description."
"DOTA_Item_Batriders_Head"	"Batrider の頭部"
"[english]DOTA_Item_Batriders_Head"	"Batrider's Head"
"DOTA_Item_Perky_Greevil_Ears"	"とがったGreevil の耳"
"[english]DOTA_Item_Perky_Greevil_Ears"	"Perky Greevil Ears"
"DOTA_Item_Short_Greevil_Hair"	"短い Greevil の毛"
"[english]DOTA_Item_Short_Greevil_Hair"	"Short Greevil Hair"
"DOTA_Item_Long_Greevil_Hair"	"長い Greevil の毛"
"[english]DOTA_Item_Long_Greevil_Hair"	"Long Greevil Hair"
"DOTA_Item_Desc_Copy_of_Medusas_Bow"	"この新しいアイテムには説明がありません。"
"[english]DOTA_Item_Desc_Copy_of_Medusas_Bow"	"This new item has no description."
"DOTA_Item_Desc_Copy_of_Medusas_Veil"	"この新しいアイテムには説明がありません。"
"[english]DOTA_Item_Desc_Copy_of_Medusas_Veil"	"This new item has no description."
"DOTA_Item_Medusas_Bracers"	"Medusa の籠手"
"[english]DOTA_Item_Medusas_Bracers"	"Medusa's Bracers"
"DOTA_Item_Desc_Copy_of_Medusas_Chest_Armor"	"この新しいアイテムには説明がありません。"
"[english]DOTA_Item_Desc_Copy_of_Medusas_Chest_Armor"	"This new item has no description."
"DOTA_Item_Desc_Copy_of_Medusas_Bracers"	"この新しいアイテムには説明がありません。"
"[english]DOTA_Item_Desc_Copy_of_Medusas_Bracers"	"This new item has no description."
"DOTA_Item_Desc_Copy_of_Shredder_Drivers_Hat"	"この新しいアイテムには説明がありません。"
"[english]DOTA_Item_Desc_Copy_of_Shredder_Drivers_Hat"	"This new item has no description."
"DOTA_Item_Desc_Copy_of_Shredders_Claw"	"この新しいアイテムには説明がありません。"
"[english]DOTA_Item_Desc_Copy_of_Shredders_Claw"	"This new item has no description."
"DOTA_Item_Shredders_Shoulder_Armor"	"Shredder の肩鎧"
"[english]DOTA_Item_Shredders_Shoulder_Armor"	"Shredder's Shoulder Armor"
"DOTA_Item_Desc_Copy_of_Shredders_Chainsaw"	"この新しいアイテムには説明がありません。"
"[english]DOTA_Item_Desc_Copy_of_Shredders_Chainsaw"	"This new item has no description."
"DOTA_Item_Desc_Copy_of_Shredders_Shoulder_Armor"	"この新しいアイテムには説明がありません。"
"[english]DOTA_Item_Desc_Copy_of_Shredders_Shoulder_Armor"	"This new item has no description."
"DOTA_Item_Undyings_Bracer"	"Undying の籠手"
"[english]DOTA_Item_Undyings_Bracer"	"Undying's Bracer"
"DOTA_Item_Desc_Copy_of_Undyings_Bracer"	"この新しいアイテムには説明がありません。"
"[english]DOTA_Item_Desc_Copy_of_Undyings_Bracer"	"This new item has no description."
"DOTA_Item_Desc_Copy_of_Undyings_Helmet"	"この新しいアイテムには説明がありません。"
"[english]DOTA_Item_Desc_Copy_of_Undyings_Helmet"	"This new item has no description."
"DOTA_Item_Undyings_Shoulder_Armor"	"Undying の肩鎧"
"[english]DOTA_Item_Undyings_Shoulder_Armor"	"Undying's Shoulder Armor"
"DOTA_Item_Desc_Copy_of_Undyings_Armor"	"この新しいアイテムには説明がありません。"
"[english]DOTA_Item_Desc_Copy_of_Undyings_Armor"	"This new item has no description."
"DOTA_Item_Dragon_Knight_Ward"	"Dragon Knight ワード"
"[english]DOTA_Item_Dragon_Knight_Ward"	"Dragon Knight Ward"
"DOTA_Item_Desc_Dragon_Knight_Ward"	"Dragon Knight ワードの説明"
"[english]DOTA_Item_Desc_Dragon_Knight_Ward"	"Description of the Dragon Knight Ward"
"DOTA_WearableType_Hair_and_Circlet"	"髪型とサークレット"
"[english]DOTA_WearableType_Hair_and_Circlet"	"Hair and Circlet"
"DOTA_Item_Spectres_weapon"	"Spectres の武器"
"[english]DOTA_Item_Spectres_weapon"	"Spectres weapon"
"DOTA_Item_Desc_Spectres_weapon"	"Spectres の武器"
"[english]DOTA_Item_Desc_Spectres_weapon"	"Spectres Weapon"
"DOTA_Item_Shadow_Demons_Cape"	"Shadow Demon の肩マント"
"[english]DOTA_Item_Shadow_Demons_Cape"	"Shadow Demon's Cape"
"DOTA_Item_Desc_Copy_of_Shadow_Demons_Cape"	"この新しいアイテムには説明がありません。"
"[english]DOTA_Item_Desc_Copy_of_Shadow_Demons_Cape"	"This new item has no description."
"DOTA_Item_Desc_Copy_of_Shadow_Demons_Armor"	"この新しいアイテムには説明がありません。"
"[english]DOTA_Item_Desc_Copy_of_Shadow_Demons_Armor"	"This new item has no description."
"DOTA_Item_Desc_Copy_of_Shadow_Demons_Belt"	"この新しいアイテムには説明がありません。"
"[english]DOTA_Item_Desc_Copy_of_Shadow_Demons_Belt"	"This new item has no description."
"DOTA_Item_dazzle_yuwipi_weapon"	"dazzle_yuwipi_weapon"
"[english]DOTA_Item_dazzle_yuwipi_weapon"	"dazzle_yuwipi_weapon"
"DOTA_Item_The_Storm_Riders_Bracer"	"Storm Rider の籠手"
"[english]DOTA_Item_The_Storm_Riders_Bracer"	"The Storm Rider's Bracer"
"DOTA_Item_Desc_Red_Talon_Hood"	"赤い頭巾に赤い鍵爪、この頭飾りでBeastmaster を自然から守る。"
"[english]DOTA_Item_Desc_Red_Talon_Hood"	"Red of hood and red of claw, this headpiece shields the Beastmaster from the elements."
"DOTA_Item_Desc_Red_Talon_Guard"	"重量はBeastmaster の肩にのしかかるが、その外套の強靭さは彼を支える。"
"[english]DOTA_Item_Desc_Red_Talon_Guard"	"Heavy is the burden shouldered by the Beastmaster, and strong is the mantle that supports him."
"DOTA_Item_Red_Talon_Bracers"	"Red Talon の籠手"
"[english]DOTA_Item_Red_Talon_Bracers"	"Red Talon Bracers"
"DOTA_Item_Ancestral_Headdress"	"Ancestral Headdress"
"[english]DOTA_Item_Ancestral_Headdress"	"Ancestral Headdress"
"DOTA_Item_Frosty_Treasure_of_Frostivus"	"Frostivus の 凍った宝箱"
"[english]DOTA_Item_Frosty_Treasure_of_Frostivus"	"Frosty Treasure of Frostivus"
"DOTA_Item_Treasure_Key_Frostivus"	"Frostivus 宝箱の鍵"
"[english]DOTA_Item_Treasure_Key_Frostivus"	"Frostivus Treasure Key"
"DOTA_Item_Bastion_Announcer_Pack"	"Bastion アナウンサーパック"
"[english]DOTA_Item_Bastion_Announcer_Pack"	"Bastion Announcer Pack"
"DOTA_Item_Axe_Announcer_Pack"	"Axe アナウンサーパック"
"[english]DOTA_Item_Axe_Announcer_Pack"	"Axe Announcer Pack"
"DOTA_Item_Juggernaut_Announcer_Pack"	"Juggernaut アナウンサーパック"
"[english]DOTA_Item_Juggernaut_Announcer_Pack"	"Juggernaut Announcer Pack"
"DOTA_Item_Natures_Prophet_Announcer_Pack"	"Nature's Prophet アナウンサーパック"
"[english]DOTA_Item_Natures_Prophet_Announcer_Pack"	"Nature's Prophet Announcer Pack"
"DOTA_Item_Storm_Spirit_Announcer_Pack"	"Storm Spirit アナウンサーパック"
"[english]DOTA_Item_Storm_Spirit_Announcer_Pack"	"Storm Spirit Announcer Pack"
"DOTA_Item_The_Pirate_Capn_Announcer_Pack"	"The Pirate Cap'n アナウンサーパック"
"[english]DOTA_Item_The_Pirate_Capn_Announcer_Pack"	"The Pirate Cap'n Announcer Pack"
"DOTA_Item_Hunter_of_the_Red_Talon_Set"	"Hunter of the Red Talon セット"
"[english]DOTA_Item_Hunter_of_the_Red_Talon_Set"	"Hunter of the Red Talon Set"
"DOTA_Item_Desc_Hunter_of_the_Red_Talon_Set"	"Slom 王国での束縛を逃れて以来、Beastmaster は常に周囲の自然界の力を利用するようにになった。 他のヒーローが鉄や魔術を使うのに対し、彼は古代からの道具、つまりは羽、皮、骨や毛皮を用いる。これらの原始的な道具と共に、この上なく武装した騎士に対しても上手く立ち回ることが出来るという彼の価値は証明されている。本バンドルには、Beastmaster 用の 'Hunter of the Red Talon' セット内に含まれた全アイテムが含まれます："
"[english]DOTA_Item_Desc_Hunter_of_the_Red_Talon_Set"	"Since escaping bondage in kingdom of Slom, Beastmaster has always drawn strength from the natural world around him. When other heroes turn to steel or magic, Beastmaster turns to more ancient implements: feathers, leathers, bones and fur.  With these primitive tools, he's proven his worth against even the most well-armed knight. This bundle contains all of the items in the 'Hunter of the Red Talon' set for Beastmaster:"
"DOTA_Item_Gear_of_the_TallyHo_Hunter_Set"	"Gear of the Tally-Ho Hunter セット"
"[english]DOTA_Item_Gear_of_the_TallyHo_Hunter_Set"	"Gear of the Tally-Ho Hunter Set"
"DOTA_Item_Rider_of_the_Storm_Set"	"Rider of the Storm セット"
"[english]DOTA_Item_Rider_of_the_Storm_Set"	"Rider of the Storm Set"
"DOTA_Item_Shredders_Bracer"	"Shredder の籠手"
"[english]DOTA_Item_Shredders_Bracer"	"Shredder's Bracer"
"DOTA_Item_Shredders_Off_Hand_Bracer"	"Shredder の籠手（逆腕）"
"[english]DOTA_Item_Shredders_Off_Hand_Bracer"	"Shredder's Off Hand Bracer"
"DOTA_Item_Desc_Copy_of_Miranas_Bow"	"この新しいアイテムには説明がありません。"
"[english]DOTA_Item_Desc_Copy_of_Miranas_Bow"	"This new item has no description."
"DOTA_Item_Miranas_Headdress"	"Mirana の頭飾り"
"[english]DOTA_Item_Miranas_Headdress"	"Mirana's Headdress"
"DOTA_Item_Desc_Copy_of_Miranas_Mount"	"この新しいアイテムには説明がありません。"
"[english]DOTA_Item_Desc_Copy_of_Miranas_Mount"	"This new item has no description."
"DOTA_Item_Miranas_Cape"	"Mirana の肩マント"
"[english]DOTA_Item_Miranas_Cape"	"Mirana's Cape"
"DOTA_Item_Desc_Copy_of_Miranas_Headdress"	"この新しいアイテムには説明がありません。"
"[english]DOTA_Item_Desc_Copy_of_Miranas_Headdress"	"This new item has no description."
"DOTA_Item_Desc_Copy_of_Miranas_Cape"	"この新しいアイテムには説明がありません。"
"[english]DOTA_Item_Desc_Copy_of_Miranas_Cape"	"This new item has no description."
"DOTA_Item_Miranas_Bracers"	"Mirana の籠手"
"[english]DOTA_Item_Miranas_Bracers"	"Mirana's Bracers"
"DOTA_Item_Desc_Copy_of_Miranas_Shoulders"	"この新しいアイテムには説明がありません。"
"[english]DOTA_Item_Desc_Copy_of_Miranas_Shoulders"	"This new item has no description."
"DOTA_Item_Miranas_Quiver"	"Mirana の矢筒"
"[english]DOTA_Item_Miranas_Quiver"	"Mirana's Quiver"
"DOTA_Item_Desc_Copy_of_Miranas_Bracers"	"この新しいアイテムには説明がありません。"
"[english]DOTA_Item_Desc_Copy_of_Miranas_Bracers"	"This new item has no description."
"DOTA_Item_Desc_troll_warlord_base_arms"	"基本、腕"
"[english]DOTA_Item_Desc_troll_warlord_base_arms"	"base arms"
"DOTA_Item_Desc_Treasure_of_Dark_Implements"	"何が入っているかは分からない密かに光る宝箱。開けるには、 Dark 宝箱の鍵が必要です。"
"[english]DOTA_Item_Desc_Treasure_of_Dark_Implements"	"A darkly gleaming treasure with mysterious contents. You must use a Dark Treasure Key to open this."
"DOTA_Item_Dark_Treasure_Key"	"Dark 宝箱の鍵"
"[english]DOTA_Item_Dark_Treasure_Key"	"Dark Treasure Key"
"DOTA_Item_Light_of_the_Solar_Divine_Set"	"Light of the Solar Divine （セット）"
"[english]DOTA_Item_Light_of_the_Solar_Divine_Set"	"Light of the Solar Divine Set"
"DOTA_Item_Troll_Warlords_Default_Weapon"	"Troll Warlordの武器（ディフォルト）"
"[english]DOTA_Item_Troll_Warlords_Default_Weapon"	"Troll Warlord's Default Weapon"
"DOTA_Item_Desc_Troll_Warlords_Default_Weapon"	"Troll Warlord の武器（ディフォルト）"
"[english]DOTA_Item_Desc_Troll_Warlords_Default_Weapon"	"Troll Warlord's Default Weapon"
"DOTA_Item_Troll_Warlords_Default_OffHand_Weapon"	"Troll Warlord の武器（逆腕、ディフォルト）"
"[english]DOTA_Item_Troll_Warlords_Default_OffHand_Weapon"	"Troll Warlord's Default Off-Hand Weapon"
"DOTA_Item_Desc_Troll_Warlords_Default_OffHand_Weapon"	"Troll Warlord の武器（ディフォルト、逆腕）"
"[english]DOTA_Item_Desc_Troll_Warlords_Default_OffHand_Weapon"	"Troll Warlord's Default Off-Hand Weapon"
"DOTA_Item_Troll_Warlords_Default_Melee_Weapon"	"Troll Warlord の武器（Melee、ディフォルト）"
"[english]DOTA_Item_Troll_Warlords_Default_Melee_Weapon"	"Troll Warlord's Default Melee Weapon"
"DOTA_Item_Desc_Troll_Warlords_Default_Melee_Weapon"	"Troll Warlord の武器（Melee、ディフォルト）"
"[english]DOTA_Item_Desc_Troll_Warlords_Default_Melee_Weapon"	"Troll Warlord's Default Melee Weapon"
"DOTA_Item_Troll_Warlords_Default_Melee_OffHand_Weapon"	"Troll Warlord の武器（Melee、ディフォルト、逆腕）"
"[english]DOTA_Item_Troll_Warlords_Default_Melee_OffHand_Weapon"	"Troll Warlord's Default Melee Off-Hand Weapon"
"DOTA_Item_Desc_Troll_Warlords_Default_Melee_OffHand_Weapon"	"Troll Warlord の武器（Melee、ディフォルト、逆腕）"
"[english]DOTA_Item_Desc_Troll_Warlords_Default_Melee_OffHand_Weapon"	"Troll Warlord's Default Melee Off-Hand Weapon"
"DOTA_Item_Troll_Warlords_Default_Arms"	"Troll Warlord の腕部（ディフォルト）"
"[english]DOTA_Item_Troll_Warlords_Default_Arms"	"Troll Warlord's Default Arms"
"DOTA_Item_Desc_Troll_Warlords_Default_Arms"	"Troll Warlord の腕部（ディフォルト）"
"[english]DOTA_Item_Desc_Troll_Warlords_Default_Arms"	"Troll Warlord's Default Arms"
"DOTA_Item_Relics_of_the_Putrid_Pontiff_Set"	"Relics of the Putrid Pontiff セット"
"[english]DOTA_Item_Relics_of_the_Putrid_Pontiff_Set"	"Relics of the Putrid Pontiff Set"
"DOTA_Item_Desc_The_Demonic_Archivist_Set"	"このバンドルには Warlock 用の 'Demonic Archivist' セット内の全てのアイテムが含まれます："
"[english]DOTA_Item_Desc_The_Demonic_Archivist_Set"	"This bundle contains all of the items in the 'Demonic Archivist' set for Warlock:"
"DOTA_Item_Slardar_Weapon"	"Slardar の武器"
"[english]DOTA_Item_Slardar_Weapon"	"Slardar Weapon"
"DOTA_Item_Slardar_Head"	"Slardar の頭部"
"[english]DOTA_Item_Slardar_Head"	"Slardar Head"
"DOTA_Item_Slardar_Arms"	"Slardar の腕部"
"[english]DOTA_Item_Slardar_Arms"	"Slardar Arms"
"DOTA_Item_Weaver_Arms"	"Weaver の腕部"
"[english]DOTA_Item_Weaver_Arms"	"Weaver Arms"
"DOTA_Item_Snipers_Weapon"	"Sniper の武器"
"[english]DOTA_Item_Snipers_Weapon"	"Sniper's Weapon"
"DOTA_Item_Snipers_Cape"	"Sniper の肩マント"
"[english]DOTA_Item_Snipers_Cape"	"Sniper's Cape"
"DOTA_Item_Desc_Copy_of_Snipers_Weapon"	"この新しいアイテムには説明がありません。"
"[english]DOTA_Item_Desc_Copy_of_Snipers_Weapon"	"This new item has no description."
"DOTA_Item_Snipers_Head_Gear"	"Sniper のかぶり物"
"[english]DOTA_Item_Snipers_Head_Gear"	"Sniper's Head Gear"
"DOTA_Item_Desc_Copy_of_Snipers_Cape"	"この新しいアイテムには説明がありません。"
"[english]DOTA_Item_Desc_Copy_of_Snipers_Cape"	"This new item has no description."
"DOTA_Item_Snipers_Shoulder_Armor"	"Sniper の肩鎧"
"[english]DOTA_Item_Snipers_Shoulder_Armor"	"Sniper's Shoulder Armor"
"DOTA_Item_Desc_Copy_of_Snipers_Head_Gear"	"この新しいアイテムには説明がありません。"
"[english]DOTA_Item_Desc_Copy_of_Snipers_Head_Gear"	"This new item has no description."
"DOTA_Item_Snipers_Bracers"	"Sniper の籠手"
"[english]DOTA_Item_Snipers_Bracers"	"Sniper's Bracers"
"DOTA_Item_Desc_Copy_of_Snipers_Shoulder_Armor"	"この新しいアイテムには説明がありません。"
"[english]DOTA_Item_Desc_Copy_of_Snipers_Shoulder_Armor"	"This new item has no description."
"DOTA_Item_Enchantress_Hair"	"Enchantress の髪型"
"[english]DOTA_Item_Enchantress_Hair"	"Enchantress' Hair"
"DOTA_Item_Desc_Copy_of_Enchantress_Necklace"	"この新しいアイテムには説明がありません。"
"[english]DOTA_Item_Desc_Copy_of_Enchantress_Necklace"	"This new item has no description."
"DOTA_Item_Desc_Copy_of_Enchantress_Hair"	"この新しいアイテムには説明がありません。"
"[english]DOTA_Item_Desc_Copy_of_Enchantress_Hair"	"This new item has no description."
"DOTA_Item_Enchantress_Bracers"	"Enchantress の籠手"
"[english]DOTA_Item_Enchantress_Bracers"	"Enchantress' Bracers"
"DOTA_Item_Desc_Copy_of_Enchantress_Dress"	"この新しいアイテムには説明がありません。"
"[english]DOTA_Item_Desc_Copy_of_Enchantress_Dress"	"This new item has no description."
"DOTA_Item_Enchantress_Weapon"	"Enchantress の武器"
"[english]DOTA_Item_Enchantress_Weapon"	"Enchantress' Weapon"
"DOTA_Item_Desc_Copy_of_Enchantress_Bracers"	"この新しいアイテムには説明がありません。"
"[english]DOTA_Item_Desc_Copy_of_Enchantress_Bracers"	"This new item has no description."
"DOTA_Item_Desc_venomancers_mandibles"	"この新しいアイテムには説明がありません。"
"[english]DOTA_Item_Desc_venomancers_mandibles"	"This new item has no description."
"DOTA_Item_Desc_Copy_of_venomancers_mandibles"	"この新しいアイテムには説明がありません。"
"[english]DOTA_Item_Desc_Copy_of_venomancers_mandibles"	"This new item has no description."
"DOTA_Item_Desc_Venomancers_Limbs"	"この新しいアイテムには説明がありません。"
"[english]DOTA_Item_Desc_Venomancers_Limbs"	"This new item has no description."
"DOTA_Item_Desc_Copy_of_Venomancers_Limbs"	"この新しいアイテムには説明がありません。"
"[english]DOTA_Item_Desc_Copy_of_Venomancers_Limbs"	"This new item has no description."
"DOTA_Item_Venomancers_Wards"	"Venomancer のワード"
"[english]DOTA_Item_Venomancers_Wards"	"Venomancer's Wards"
"DOTA_Item_Desc_Copy_of_Venomancers_Tail"	"この新しいアイテムには説明がありません。"
"[english]DOTA_Item_Desc_Copy_of_Venomancers_Tail"	"This new item has no description."
"DOTA_Item_Desc_Copy_of_Meepos_Weapon"	"この新しいアイテムには説明がありません。"
"[english]DOTA_Item_Desc_Copy_of_Meepos_Weapon"	"This new item has no description."
"DOTA_Item_Desc_Copy_of_Meepos_Hood"	"この新しいアイテムには説明がありません。"
"[english]DOTA_Item_Desc_Copy_of_Meepos_Hood"	"This new item has no description."
"DOTA_Item_Desc_Copy_of_Meepos_Backpack"	"この新しいアイテムには説明がありません。"
"[english]DOTA_Item_Desc_Copy_of_Meepos_Backpack"	"This new item has no description."
"DOTA_Item_Meepos_Bracers"	"Meepo の籠手"
"[english]DOTA_Item_Meepos_Bracers"	"Meepo's Bracers"
"DOTA_Item_Desc_Copy_of_Meepos_Shoulderpads"	"この新しいアイテムには説明がありません。"
"[english]DOTA_Item_Desc_Copy_of_Meepos_Shoulderpads"	"This new item has no description."
"DOTA_Item_Desc_Copy_of_Meepos_Bracers"	"この新しいアイテムには説明がありません。"
"[english]DOTA_Item_Desc_Copy_of_Meepos_Bracers"	"This new item has no description."
"DOTA_Item_Silencers_Bracers"	"Silencer の籠手"
"[english]DOTA_Item_Silencers_Bracers"	"Silencer's Bracers"
"DOTA_Item_Gilded_Falcon_Quiver"	"Gilded Falcon の矢筒"
"[english]DOTA_Item_Gilded_Falcon_Quiver"	"Gilded Falcon Quiver"
"DOTA_Item_Desc_Treasure_of_the_Restless_Seas"	"この箱を開けるには<font color='#9da1a9'>宝箱の鍵</font>が必要です。DOTA 2 ストアで購入できます。各箱シリーズ毎にに入っている宝は異なります。"
"[english]DOTA_Item_Desc_Treasure_of_the_Restless_Seas"	"You will need a <font color='#9da1a9'>Treasure Key</font> to open this chest. You can pick one up at the DOTA 2 Store. Each chest series comes with a different selection of possible loot."
"DOTA_Item_Desc_Treasure_of_Tidal_Power"	"この箱を開けるには<font color='#9da1a9'>宝箱の鍵</font>が必要です。DOTA 2 ストアで購入できます。各箱シリーズ毎にに入っている宝は異なります。"
"[english]DOTA_Item_Desc_Treasure_of_Tidal_Power"	"You will need a <font color='#9da1a9'>Treasure Key</font> to open this chest. You can pick one up at the DOTA 2 Store. Each chest series comes with a different selection of possible loot."
"DOTA_Item_Arms_of_the_Penitent_Nomad_Set"	"Arms of the Penitent Nomad セット"
"[english]DOTA_Item_Arms_of_the_Penitent_Nomad_Set"	"Arms of the Penitent Nomad Set"
"DOTA_Item_Desc_Arms_of_the_Penitent_Nomad_Set"	"このバンドルには Chen 用の 'Arms of the Penitent Nomad Set' セット内の全てのアイテムが含まれます："
"[english]DOTA_Item_Desc_Arms_of_the_Penitent_Nomad_Set"	"This bundle contains all of the items in the 'Arms of the Penitent Nomad Set' set for Chen:"
"DOTA_Item_Desc_The_Gifts_of_Yoskreth"	"このバンドルには Anti-Mage 用の 'Gifts of Yoskreth' セット内の全てのアイテムが含まれます："
"[english]DOTA_Item_Desc_The_Gifts_of_Yoskreth"	"This bundle contains all of the items in the 'Gifts of Yoskreth' set for Anti-Mage:"
"DOTA_Item_Desc_Wings_of_the_Gilded_Falcon_Set"	"このバンドルには Windrunner 用の 'Wings of the Gilded Falcon'セット内の全てのアイテムが含まれます：翼の様に早く、羽の様に軽く、太陽の用に輝く；'Wings of the Gilded Falcon セットは希少価値は高い危険な捕食者へのトリビュートです。"
"[english]DOTA_Item_Desc_Wings_of_the_Gilded_Falcon_Set"	"This bundle contains all of the items in the 'Wings of the Gilded Falcon' set for Windranger:  Quick as wings, light as feathers, golden as the sun; the wings of the guilded Falcon set is a tribute to a rare and deadly predator."
"DOTA_Item_Blessings_of_the_Wildwing_Set"	"Blessings of the Wildwing セット"
"[english]DOTA_Item_Blessings_of_the_Wildwing_Set"	"Blessings of the Wildwing Set"
"DOTA_Item_Desc_Juggernauts_Weapon"	""
"[english]DOTA_Item_Desc_Juggernauts_Weapon"	""
"DOTA_Item_Tusks_Hat"	"Tusk の帽子"
"[english]DOTA_Item_Tusks_Hat"	"Tusk's Hat"
"DOTA_Item_Desc_Tusks_Hat"	"Tusk　の帽子"
"[english]DOTA_Item_Desc_Tusks_Hat"	"Tusk's Hat"
"DOTA_Item_Tusks_Horns"	"Tusk の角"
"[english]DOTA_Item_Tusks_Horns"	"Tusk's Horns"
"DOTA_Item_Tusks_Weapon"	"Tusk の武器"
"[english]DOTA_Item_Tusks_Weapon"	"Tusk's Weapon"
"DOTA_Item_Rubicks_Head"	"Rubick の頭部"
"[english]DOTA_Item_Rubicks_Head"	"Rubick's Head"
"DOTA_Item_Nightsilver_Bracers"	"Nightsilver の籠手"
"[english]DOTA_Item_Nightsilver_Bracers"	"Nightsilver Bracers"
"DOTA_Item_Nightsilver_Quiver"	"Nightsilver の矢筒"
"[english]DOTA_Item_Nightsilver_Quiver"	"Nightsilver Quiver"
"DOTA_Item_Announcer_Tuskar"	"アナウンサー： Tusk"
"[english]DOTA_Item_Announcer_Tuskar"	"Announcer: Tusk"
"DOTA_Item_Desc_Announcer_Tuskar"	"このアイテムでディフォルトのアナウンスがパンチの聞いた Tusk のセリフに換わります。"
"[english]DOTA_Item_Desc_Announcer_Tuskar"	"This item replaces the default announcer with punchy lines from Tusk."
"DOTA_Item_Harbinger_of_the_Inauspicious_Abyss_Set"	"Harbinger of the Inauspicious Abyss セット"
"[english]DOTA_Item_Harbinger_of_the_Inauspicious_Abyss_Set"	"Harbinger of the Inauspicious Abyss Set"
"DOTA_Item_Regalia_of_the_Crystalline_Queen_Set"	"Regalia of the Crystalline Queen セット"
"[english]DOTA_Item_Regalia_of_the_Crystalline_Queen_Set"	"Regalia of the Crystalline Queen Set"
"DOTA_Item_Desc_Tools_of_the_Demon_Witch_Set"	"このバンドルには Lion 用の 'Tools of the Demon Witch' セット内の全てのアイテムが含まれます："
"[english]DOTA_Item_Desc_Tools_of_the_Demon_Witch_Set"	"This bundle contains all of the items in the 'Tools of the Demon Witch' set for Lion:"
"DOTA_Item_Garments_of_the_Nightsilver_Sentinel_Set"	"Garments of the Nightsilver Sentinel セット"
"[english]DOTA_Item_Garments_of_the_Nightsilver_Sentinel_Set"	"Garments of the Nightsilver Sentinel Set"
"DOTA_Item_Treasure_Key_of_the_Forbidden_Lotus"	"Forbidden Lotus 宝箱の鍵"
"[english]DOTA_Item_Treasure_Key_of_the_Forbidden_Lotus"	"Treasure Key of the Forbidden Lotus"
"DOTA_Item_Desc_The_Bone_Scryer_Set"	"このバンドルには Death Prophet 用の 'Bone Scryer' セット内の全てのアイテムが含まれます："
"[english]DOTA_Item_Desc_The_Bone_Scryer_Set"	"This bundle contains all of the items in the 'Bone Scryer' set for Death Prophet:"
"DOTA_Item_Councilors_Raiment_Set"	"Councilor's Raiment セット"
"[english]DOTA_Item_Councilors_Raiment_Set"	"Councilor's Raiment Set"
"DOTA_Item_Arms_of_the_Bramble_Lord_Set"	"Arms of the Bramble Lord セット"
"[english]DOTA_Item_Arms_of_the_Bramble_Lord_Set"	"Arms of the Bramble Lord Set"
"DOTA_Item_Desc_Arms_of_the_Bramble_Lord"	"このバンドルには Phantom Lancer 用の 'Arms of the Bramble Lord' セット内の全てのアイテムが含まれます："
"[english]DOTA_Item_Desc_Arms_of_the_Bramble_Lord"	"This bundle contains all of the items in the 'Arms of the Bramble Lord' set for Phantom Lancer:"
"DOTA_Item_The_Apocalyptic_Fire_Set"	"The Apocalyptic Fire セット"
"[english]DOTA_Item_The_Apocalyptic_Fire_Set"	"The Apocalyptic Fire Set"
"DOTA_Item_Desc_The_Apocalyptic_Fire_Set"	"周りを燃やし、絶やされることの無い存在の彼が持つのはApocalypseの全武装。 このバンドルには Doom 用の 'Apocalyptic Fire' セット内の全てのアイテムが含まれます："
"[english]DOTA_Item_Desc_The_Apocalyptic_Fire_Set"	"He that burns and is not consumed carries with him all the armaments of the Apocalypse. This bundle contains all of the items in the 'Apocalyptic Fire' set for Doom:"
"DOTA_Item_Ceremonial_Carapace_of_Qaldin_Set"	"Ceremonial Carapace of Qaldin セット"
"[english]DOTA_Item_Ceremonial_Carapace_of_Qaldin_Set"	"Ceremonial Carapace of Qaldin Set"
"DOTA_Item_Desc_Ceremonial_Carapace_of_Qaldin_Set"	"このバンドルには Sand King 用の 'Ceremonial Carapace of Qaldin' セット内の全てのアイテムが含まれます："
"[english]DOTA_Item_Desc_Ceremonial_Carapace_of_Qaldin_Set"	"This bundle contains all of the items in the 'Ceremonial Carapace of Qaldin' set for Sand King:"
"DOTA_Item_Chains_of_the_Summoned_Lord_Set"	"Chains of the Summoned Lord セット"
"[english]DOTA_Item_Chains_of_the_Summoned_Lord_Set"	"Chains of the Summoned Lord Set"
"DOTA_Item_Skywrath_Mages_Weapon"	"Skywrath Mage の武器"
"[english]DOTA_Item_Skywrath_Mages_Weapon"	"Skywrath Mage's Weapon"
"DOTA_Item_Desc_Skywrath_Mages_Weapon"	"Skywrath Mage の武器"
"[english]DOTA_Item_Desc_Skywrath_Mages_Weapon"	"Skywrath Mage's Weapon"
"DOTA_Item_Skywrath_Mages_Head"	"Skywrath Mage の頭部"
"[english]DOTA_Item_Skywrath_Mages_Head"	"Skywrath Mage's Head"
"DOTA_Item_Desc_Skywrath_Mages_Head"	"Skywrath Mage の頭部"
"[english]DOTA_Item_Desc_Skywrath_Mages_Head"	"Skywrath Mage's Head"
"DOTA_Item_Skywrath_Mages_Bracers"	"Skywrath Mage の籠手"
"[english]DOTA_Item_Skywrath_Mages_Bracers"	"Skywrath Mage's Bracers"
"DOTA_Item_Desc_Skywrath_Mages_Bracers"	"Skywrath Mage の籠手"
"[english]DOTA_Item_Desc_Skywrath_Mages_Bracers"	"Skywrath Mage's Bracersn."
"DOTA_Item_Implements_of_the_Tahlin_Watch_Set"	"Implements of the Tahlin Watch セット"
"[english]DOTA_Item_Implements_of_the_Tahlin_Watch_Set"	"Implements of the Tahlin Watch Set"
"DOTA_Item_Desc_Implements_of_the_Tahlin_Watch_Set"	"このバンドルには Riki 用の 'Implements of the Tahlin Watch セット内の全てのアイテムが含まれます："
"[english]DOTA_Item_Desc_Implements_of_the_Tahlin_Watch_Set"	"This bundle contains all of the items in the 'Implements of the Tahlin Watch' set for Riki:"
"DOTA_Item_Crystal_Maidens_Headdress"	"Crystal Maiden の頭飾り"
"[english]DOTA_Item_Crystal_Maidens_Headdress"	"Crystal Maiden's Headdress"
"DOTA_Item_Origins_Flame_Hair"	"Origins Flame の髪型"
"[english]DOTA_Item_Origins_Flame_Hair"	"Origins Flame Hair"
"DOTA_Item_Desc_Origins_Flame_Hair"	"元々の髪型"
"[english]DOTA_Item_Desc_Origins_Flame_Hair"	"Original Hair"
"DOTA_Item_Desc_Ritual_Skirt_of_the_Father_Spirits"	"儀式用の腰巻の下に何を履いているかって？それは儀式によるのです。"
"[english]DOTA_Item_Desc_Ritual_Skirt_of_the_Father_Spirits"	"What does Dazzle wear under his ritual skirt? That depends upon the ritual."
"DOTA_Item_Treasure_Key_of_Crystalline_Chaos"	"Crystalline Chaos 宝箱の鍵"
"[english]DOTA_Item_Treasure_Key_of_Crystalline_Chaos"	"Treasure Key of Crystalline Chaos"
"DOTA_Item_Desc_Tortures_of_the_Secret_Queen_Set"	"このバンドルには Queen of Pain 用の'Tortures of the Secret Queen' セット内の全てのアイテムが含まれます："
"[english]DOTA_Item_Desc_Tortures_of_the_Secret_Queen_Set"	"This bundle contains all of the items in the 'Tortures of the Secret Queen' set for Queen of Pain:"
"DOTA_Item_Desc_The_Hidden_Talent_Set"	"Silencer は全ての魔術の内、魔法の欠如が最も偉大であることを証明する。このバンドルには Silencer 用の'Grand Inquisitor'セット内の全てのアイテムが含まれます："
"[english]DOTA_Item_Desc_The_Hidden_Talent_Set"	"Silencer proves that a lack of magic can be the greatest magic of all.  This bundle contains all of the items in the 'Grand Inquisitor' set for Silencer:"
"DOTA_Item_Carapace_of_the_Hidden_Hive_Set"	"Carapace of the Hidden Hive セット"
"[english]DOTA_Item_Carapace_of_the_Hidden_Hive_Set"	"Carapace of the Hidden Hive Set"
"DOTA_Item_Desc_Carapace_of_the_Hidden_Hive_Set"	"このバンドルには Nyx Assassin 用の'Carapace of the Hidden Hive' セット内の全てのアイテムが含まれます："
"[english]DOTA_Item_Desc_Carapace_of_the_Hidden_Hive_Set"	"This bundle contains all of the items in the 'Carapace of the Hidden Hive' set for Nyx Assassin:"
"DOTA_Item_Desc_Designs_of_the_Slithereen_Nobility_Set"	"このバンドルにはNaga Siren 用の'Designs of the Slithereen Nobility' セット内の全てのアイテムが含まれます："
"[english]DOTA_Item_Desc_Designs_of_the_Slithereen_Nobility_Set"	"This bundle contains all of the items in the 'Designs of the Slithereen Nobility' set for Naga Siren:"
"DOTA_Item_Ember_Tipped_Carapace_Set"	"Ember Tipped Carapace セット"
"[english]DOTA_Item_Ember_Tipped_Carapace_Set"	"Ember Tipped Carapace Set"
"DOTA_Item_Desc_Ember_Tipped_Carapace_Set"	"このバンドルには Weaver 用の'Ember Tipped Carapace' セット内の全てのアイテムが含まれます："
"[english]DOTA_Item_Desc_Ember_Tipped_Carapace_Set"	"This bundle contains all of the items in the 'Ember Tipped Carapace' set for Weaver:"
"DOTA_Item_Ritual_Garb_of_the_Father_Spirits_Set"	"Ritual Garb of the Father Spirits セット"
"[english]DOTA_Item_Ritual_Garb_of_the_Father_Spirits_Set"	"Ritual Garb of the Father Spirits Set"
"DOTA_Item_Desc_Ritual_Garb_of_the_Father_Spirits_Set"	"このバンドルには Dazzle 用の'Ritual Garb of the Father Spirits' セット内の全てのアイテムが含まれます："
"[english]DOTA_Item_Desc_Ritual_Garb_of_the_Father_Spirits_Set"	"This bundle contains all of the items in the 'Ritual Garb of the Father Spirits' set for Dazzle:"
"DOTA_Item_Featherfall_Quiver"	"Featherfall の矢筒"
"[english]DOTA_Item_Featherfall_Quiver"	"Featherfall Quiver"
"DOTA_Item_Councilors_Complete_Raiment_Set"	"Councilor's Complete Raiment セット"
"[english]DOTA_Item_Councilors_Complete_Raiment_Set"	"Councilor's Complete Raiment Set"
"DOTA_Item_Desc_Councilors_Complete_Raiment_Set"	"このバンドルには Rubick 用の 'Councilor's Raiment' セット内の全てのアイテムが含まれます："
"[english]DOTA_Item_Desc_Councilors_Complete_Raiment_Set"	"This bundle contains all of the items in the 'Councilor's Raiment' set for Rubick:"
"DOTA_Item_Desc_Twisted_Wisdom_Set"	"このバンドルには Leshrac 用の 'Twisted Wisdom' セット内の全てのアイテムが含まれます："
"[english]DOTA_Item_Desc_Twisted_Wisdom_Set"	"This bundle contains all of the items in the 'Twisted Wisdom' set for Leshrac:"
"DOTA_Item_Desc_The_Inscrutable_Zeal_Set"	"このバンドルには Rubick 用の 'Inscrutable Zeal' セット内の全てのアイテムが含まれます："
"[english]DOTA_Item_Desc_The_Inscrutable_Zeal_Set"	"This bundle contains all of the items in the 'Inscrutable Zeal' set for Rubick:"
"DOTA_Item_Hunter_in_Distant_Sands_Set"	"Hunter in Distant Sands セット"
"[english]DOTA_Item_Hunter_in_Distant_Sands_Set"	"Hunter in Distant Sands Set"
"DOTA_Item_Desc_Hunter_in_Distant_Sands_Set"	"このバンドルには Bounty Hunter 用の 'Hunter in Distant Sands' セット内の全てのアイテムが含まれます："
"[english]DOTA_Item_Desc_Hunter_in_Distant_Sands_Set"	"This bundle contains all of the items in the 'Hunter in Distant Sands' set for Bounty Hunter:"
"DOTA_Item_Featherfall_Set"	"Featherfall セット"
"[english]DOTA_Item_Featherfall_Set"	"Featherfall Set"
"DOTA_Item_Desc_Ancestors_Pride_Set"	"このバンドルには Phantom Lancer 用の 'Ancestors' Pride' セット内の全てのアイテムが含まれます："
"[english]DOTA_Item_Desc_Ancestors_Pride_Set"	"This bundle contains all of the items in the 'Ancestors' Pride' set for Phantom Lancer:"
"DOTA_Item_Dead_Winter_Set"	"Dead Winter セット"
"[english]DOTA_Item_Dead_Winter_Set"	"Dead Winter Set"
"DOTA_Item_Sanguine_Moon_Set"	"Sanguine Moon セット"
"[english]DOTA_Item_Sanguine_Moon_Set"	"Sanguine Moon Set"
"DOTA_Item_Sanguine_Moon_Weapons"	"Sanguine Moon の武器"
"[english]DOTA_Item_Sanguine_Moon_Weapons"	"Sanguine Moon Weapons"
"DOTA_WearableType_Shoulder_Armor"	"肩鎧"
"[english]DOTA_WearableType_Shoulder_Armor"	"Shoulder Armor"
"DOTA_Item_Armor_of_the_Sanguine_Moon_Set"	"Armor of the Sanguine Moon セット"
"[english]DOTA_Item_Armor_of_the_Sanguine_Moon_Set"	"Armor of the Sanguine Moon Set"
"DOTA_Item_Bindings_of_Enduring_Torment_Set"	"Bindings of Enduring Torment セット"
"[english]DOTA_Item_Bindings_of_Enduring_Torment_Set"	"Bindings of Enduring Torment Set"
"DOTA_Item_Desc_Bindings_of_Enduring_Torment"	"このバンドルには Queen of Pain 用の 'Bindings of Enduring Torment' セット内の全てのアイテムが含まれます："
"[english]DOTA_Item_Desc_Bindings_of_Enduring_Torment"	"This bundle contains all of the items in the 'Bindings of Enduring Torment' set for Queen of Pain:"
"DOTA_Item_Empowered_Vestments_of_the_Gods_Set"	"Empowered Vestments of the God セット"
"[english]DOTA_Item_Empowered_Vestments_of_the_Gods_Set"	"Empowered Vestments of the Gods Set"
"DOTA_Item_Heavy_Armor_of_the_World_Runner_Set"	"Heavy Armor of the World Runner セット"
"[english]DOTA_Item_Heavy_Armor_of_the_World_Runner_Set"	"Heavy Armor of the World Runner Set"
"DOTA_Item_Desc_Heavy_Armor_of_the_World_Runner_Set"	"このバンドルには 'Heavy Armor of the World Runner' セット内の全てのアイテムが含まれます："
"[english]DOTA_Item_Desc_Heavy_Armor_of_the_World_Runner_Set"	"This bundle contains all of the items in the 'Heavy Armor of the World Runner' set:"
"DOTA_Item_Desc_Copy_of_bristelback_weapon"	"この新しいアイテムには説明がありません。"
"[english]DOTA_Item_Desc_Copy_of_bristelback_weapon"	"This new item has no description."
"DOTA_Item_Desc_Copy_of_bristelback_back"	"この新しいアイテムには説明がありません。"
"[english]DOTA_Item_Desc_Copy_of_bristelback_back"	"This new item has no description."
"DOTA_Item_Desc_Copy_of_bristelback_bracer"	"この新しいアイテムには説明がありません。"
"[english]DOTA_Item_Desc_Copy_of_bristelback_bracer"	"This new item has no description."
"DOTA_Item_Desc_Copy_of_bristelback_head"	"この新しいアイテムには説明がありません。"
"[english]DOTA_Item_Desc_Copy_of_bristelback_head"	"This new item has no description."
"DOTA_Item_Legion_Commander_Bracers"	"Legion Commander の籠手"
"[english]DOTA_Item_Legion_Commander_Bracers"	"Legion Commander Bracers"
"DOTA_Item_Desc_Legion_Commander_Bracers"	"Legion Commander の籠手"
"[english]DOTA_Item_Desc_Legion_Commander_Bracers"	"Legion Commander's bracers"
"DOTA_Item_Desc_Legion_Commander_Shoulders"	"Legion Commander の肩鎧"
"[english]DOTA_Item_Desc_Legion_Commander_Shoulders"	"Legion Commander's shoulder armor"
"DOTA_Item_Legion_Commander_Weapon"	"Legion Commander の武器"
"[english]DOTA_Item_Legion_Commander_Weapon"	"Legion Commander Weapon"
"DOTA_Item_Desc_Legion_Commander_Weapon"	"Legion Commander の剣"
"[english]DOTA_Item_Desc_Legion_Commander_Weapon"	"Legion Commander's sword"
"DOTA_Item_Desc_Treasure_of_Rarities"	"この箱を開けるには<font color='#9da1a9'>宝箱の鍵</font>が必要です。DOTA 2 ストアで購入できます。各箱シリーズ毎にに入っている宝は異なります。"
"[english]DOTA_Item_Desc_Treasure_of_Rarities"	"You will need a <font color='#9da1a9'>Treasure Key</font> to open this chest. You can pick one up at the DOTA 2 Store. Each chest series comes with a different selection of possible loot."
"DOTA_WearableType_Blade_Weapon"	"刃物の武器"
"[english]DOTA_WearableType_Blade_Weapon"	"Blade Weapon"
"DOTA_Item_Custom_of_Karroch_Set"	"Custom of Karroch セット"
"[english]DOTA_Item_Custom_of_Karroch_Set"	"Custom of Karroch Set"
"DOTA_Item_Eldritch_Ice_Set"	"Eldritch Ice セット"
"[english]DOTA_Item_Eldritch_Ice_Set"	"Eldritch Ice Set"
"DOTA_Item_Desc_Eldritch_Ice_Set"	"このバンドルにはLich 用の 'Eldritch Ice' セット内の全てのアイテムが含まれます："
"[english]DOTA_Item_Desc_Eldritch_Ice_Set"	"This bundle contains all of the items in the 'Eldritch Ice' set for Lich:"
"DOTA_Item_Desc_The_Ephemeral_Haunt_Set"	"このバンドルには Spectre 用の 'Ephemeral Haunt' セット内の全てのアイテムが含まれます："
"[english]DOTA_Item_Desc_The_Ephemeral_Haunt_Set"	"This bundle contains all of the items in the 'Ephemeral Haunt' set for Spectre:"
"DOTA_Item_Vengeful_Bracers"	"Vengeful の籠手"
"[english]DOTA_Item_Vengeful_Bracers"	"Vengeful Bracers"
"DOTA_Item_Desc_Copy_of_Vengeful_Wings"	"この新しいアイテムには説明がありません。"
"[english]DOTA_Item_Desc_Copy_of_Vengeful_Wings"	"This new item has no description."
"DOTA_Item_Vengeful_Hair"	"Vengeful の髪型"
"[english]DOTA_Item_Vengeful_Hair"	"Vengeful Hair"
"DOTA_Item_Desc_Copy_of_Vengeful_Skirt"	"この新しいアイテムには説明がありません。"
"[english]DOTA_Item_Desc_Copy_of_Vengeful_Skirt"	"This new item has no description."
"DOTA_Item_Desc_Copy_of_Vengeful_Bracers"	"この新しいアイテムには説明がありません。"
"[english]DOTA_Item_Desc_Copy_of_Vengeful_Bracers"	"This new item has no description."
"DOTA_Item_Desc_Copy_of_Vengeful_Shoulders"	"この新しいアイテムには説明がありません。"
"[english]DOTA_Item_Desc_Copy_of_Vengeful_Shoulders"	"This new item has no description."
"DOTA_Item_Vengeful_Weapon"	"Vengeful の武器"
"[english]DOTA_Item_Vengeful_Weapon"	"Vengeful Weapon"
"DOTA_Item_Desc_Copy_of_Vengeful_Hair"	"この新しいアイテムには説明がありません。"
"[english]DOTA_Item_Desc_Copy_of_Vengeful_Hair"	"This new item has no description."
"DOTA_Item_Desc_Copy_of_Vengeful_Weapon"	"この新しいアイテムには説明がありません。"
"[english]DOTA_Item_Desc_Copy_of_Vengeful_Weapon"	"This new item has no description."
"DOTA_Item_Treasure_Key_of_the_Cursed_Wood"	"Cursed Wood 宝箱の鍵"
"[english]DOTA_Item_Treasure_Key_of_the_Cursed_Wood"	"Treasure Key of the Cursed Wood"
"DOTA_Item_Treasure_Key_of_the_Shaper_Divine"	"Shaper Divine 宝箱の鍵"
"[english]DOTA_Item_Treasure_Key_of_the_Shaper_Divine"	"Treasure Key of the Shaper Divine"
"DOTA_Item_Ormr_the_Lunar_Dragon"	"Ormr the Lunar Dragon"
"[english]DOTA_Item_Ormr_the_Lunar_Dragon"	"Ormr the Lunar Dragon"
"DOTA_Item_Sacred_Bones_Offhand_Weapon"	"Sacred Bones の武器（逆腕）"
"[english]DOTA_Item_Sacred_Bones_Offhand_Weapon"	"Sacred Bones Offhand Weapon"
"DOTA_Item_Desc_Ormr_the_Lunar_Dragon"	"いつもは月の暗い部分を警備している竜の一族の Ormr は世界を見てみたかった。"
"[english]DOTA_Item_Desc_Ormr_the_Lunar_Dragon"	"From a race of dragons that normally patrols the dark side of the moon, Ormr wanted to see the world."
"DOTA_Item_Sacred_Bones_Set"	"Sacred Bones セット"
"[english]DOTA_Item_Sacred_Bones_Set"	"Sacred Bones Set"
"DOTA_Item_Spoils_of_the_Bone_Ruins_Set"	"Spoils of the Bone Ruins セット"
"[english]DOTA_Item_Spoils_of_the_Bone_Ruins_Set"	"Spoils of the Bone Ruins Set"
"DOTA_Item_Desc_Sea_Dragons_Set"	"このバンドルには Slardar 用の 'Sea Dragon' セット内の全てのアイテムが含まれます："
"[english]DOTA_Item_Desc_Sea_Dragons_Set"	"This bundle contains all of the items in the 'Sea Dragon' set for Slardar:"
"DOTA_Item_Attributes_of_the_Foretold_Set"	"Attributes of the Foretold セット"
"[english]DOTA_Item_Attributes_of_the_Foretold_Set"	"Attributes of the Foretold Set"
"DOTA_Item_Desc_Attributes_of_the_Foretold_Set"	"このセットを購入することは避けられない決断でした。 このバンドルには Keeper of the Light 用の 'Attributes of the Foretold' セット内の全てのアイテムが含まれます："
"[english]DOTA_Item_Desc_Attributes_of_the_Foretold_Set"	"It is a foregone conclusion that you buy this set.  This bundle contains all of the items in the 'Attributes of the Foretold' set for Keeper of the Light:"
"DOTA_Item_Caustic_Steel_Set"	"Caustic Steel セット"
"[english]DOTA_Item_Caustic_Steel_Set"	"Caustic Steel Set"
"DOTA_Item_Desc_Caustic_Steel_Set"	"このバンドルには Alchemist 用の 'Caustic Steel' セット内の全てのアイテムが含まれます："
"[english]DOTA_Item_Desc_Caustic_Steel_Set"	"This bundle contains all of the items in the 'Caustic Steel' set for Alchemist:"
"DOTA_Item_Penumbral_Vesture_Set"	"Penumbral Vesture セット"
"[english]DOTA_Item_Penumbral_Vesture_Set"	"Penumbral Vesture Set"
"DOTA_Item_Desc_Penumbral_Vesture_Set"	"このバンドルには Phantom Assassin 用の 'Penumbral Vesture' セット内の全てのアイテムが含まれます："
"[english]DOTA_Item_Desc_Penumbral_Vesture_Set"	"This bundle contains all of the items in the 'Penumbral Vesture' set for Phantom Assassin:"
"DOTA_Item_The_Ancient_Sovereign_Set"	"The Ancient Sovereign セット"
"[english]DOTA_Item_The_Ancient_Sovereign_Set"	"The Ancient Sovereign Set"
"DOTA_Item_The_Battle_Caster_Set"	"The Battle Caster セット"
"[english]DOTA_Item_The_Battle_Caster_Set"	"The Battle Caster Set"
"DOTA_Item_Desc_The_Battle_Caster_Set"	"このバンドルには Lina 用の 'Battle Caster' セット内の全てのアイテムが含まれます："
"[english]DOTA_Item_Desc_The_Battle_Caster_Set"	"This bundle contains all of the items in the 'Battle Caster' set for Lina:"
"DOTA_Item_Desc_The_Conquering_Tyrant_Set"	"征服者には本当の価値のある戦闘具を。このバンドルには Centaur Warrunner 用の 'Conquering Tyrant' セット内の全てのアイテムが含まれます："
"[english]DOTA_Item_Desc_The_Conquering_Tyrant_Set"	"War kit truly worthy of a conquerer.  This bundle contains all of the items in the 'Conquering Tyrant' set for Centaur Warrunner:"
"DOTA_Item_Desc_The_Moon_Rider_Set"	"このバンドルには Mirana 用の 'Moon Rider' セット内の全てのアイテムが含まれます："
"[english]DOTA_Item_Desc_The_Moon_Rider_Set"	"This bundle contains all of the items in the 'Moon Rider' set for Mirana:"
"DOTA_Item_Lion_Quiver_of_the_Moon_Rider"	"Lion Quiver of the Moon Rider"
"[english]DOTA_Item_Lion_Quiver_of_the_Moon_Rider"	"Lion Quiver of the Moon Rider"
"DOTA_Set_Attributes_of_the_Foretold"	"Attributes of the Foretold"
"[english]DOTA_Set_Attributes_of_the_Foretold"	"Attributes of the Foretold"
"DOTA_Item_Arctic_Hunter_Set"	"Arctic Hunter セット"
"[english]DOTA_Item_Arctic_Hunter_Set"	"Arctic Hunter Set"
"DOTA_Item_Treasure_Key_of_the_Malignant_Amanita"	"Malignant Amanita 宝箱の鍵"
"[english]DOTA_Item_Treasure_Key_of_the_Malignant_Amanita"	"Treasure Key of the Malignant Amanita"
"DOTA_Item_Arctic_Hunters_Tusks"	"Arctic Hunter's Tusks"
"[english]DOTA_Item_Arctic_Hunters_Tusks"	"Arctic Hunter's Tusks"
"DOTA_Item_Pyrion_Flax_Announcer_Pack"	"Pyrion Flax アナウンサーパック"
"[english]DOTA_Item_Pyrion_Flax_Announcer_Pack"	"Pyrion Flax Announcer Pack"
"DOTA_Item_Wraps_of_the_Wicked_Succubus"	"Wraps of the Wicked Succubus"
"[english]DOTA_Item_Wraps_of_the_Wicked_Succubus"	"Wraps of the Wicked Succubus"
"DOTA_Item_Desc_Wraps_of_the_Wicked_Succubus"	"戦闘にふさわしい服装が必要だ。大虐殺となると..."
"[english]DOTA_Item_Desc_Wraps_of_the_Wicked_Succubus"	"One must bring the appropriate attire to a battle.  To a massacre, however..."
"DOTA_Item_Armored_Exoskeleton_Arms"	"Armored Exoskeleton の腕部"
"[english]DOTA_Item_Armored_Exoskeleton_Arms"	"Armored Exoskeleton Arms"
"DOTA_Item_Desc_Wicked_Succubus_Set"	"このバンドルに Queen of Pain 用の 'Wicked Succubus' セット内の全てのアイテムが含まれます："
"[english]DOTA_Item_Desc_Wicked_Succubus_Set"	"This bundle contains all of the items in the 'Wicked Succubus' set for Queen of Pain:"
"DOTA_WearableType_Tusks"	"牙"
"[english]DOTA_WearableType_Tusks"	"Tusks"
"DOTA_WearableType_Horns_and_Hair"	"角と髪型"
"[english]DOTA_WearableType_Horns_and_Hair"	"Horns and Hair"
"DOTA_Item_Desc_Scythe_of_Vyse"	"Vyse 教の信者が最も大事に保護していた品で、その魔法特性より誰もが望むアイテム。"
"[english]DOTA_Item_Desc_Scythe_of_Vyse"	"The most guarded relic of the cult of Vyse, it is a weapon coveted for its magical properties."
"DOTA_Item_Aspects_of_Summer_Set"	"Aspects of Summer セット"
"[english]DOTA_Item_Aspects_of_Summer_Set"	"Aspects of Summer Set"
"DOTA_Item_Desc_Aspects_of_Summer_Set"	"このバンドルには Enchantress 用の 'Aspects of Summer' セット内の全てのアイテムが含まれます："
"[english]DOTA_Item_Desc_Aspects_of_Summer_Set"	"This bundle contains all of the items in the 'Aspects of Summer' set for Enchantress:"
"DOTA_Item_Desc_Copy_of_Lunas_Helmet"	"この新しいアイテムには説明がありません。"
"[english]DOTA_Item_Desc_Copy_of_Lunas_Helmet"	"This new item has no description."
"DOTA_Item_Desc_Copy_of_Lunas_Mount"	"この新しいアイテムには説明がありません。"
"[english]DOTA_Item_Desc_Copy_of_Lunas_Mount"	"This new item has no description."
"DOTA_Item_Desc_Copy_of_Lunas_Shield"	"この新しいアイテムには説明がありません。"
"[english]DOTA_Item_Desc_Copy_of_Lunas_Shield"	"This new item has no description."
"DOTA_Item_Desc_Copy_of_Lunas_Weapon"	"この新しいアイテムには説明がありません。"
"[english]DOTA_Item_Desc_Copy_of_Lunas_Weapon"	"This new item has no description."
"DOTA_Item_Desc_Forsaken_Beauty_Set"	"このバンドルには Medusa 用の 'Forsaken Beauty' セット内の全てのアイテムが含まれます："
"[english]DOTA_Item_Desc_Forsaken_Beauty_Set"	"This bundle contains all of the items in the 'Forsaken Beauty' set for Medusa:"
"DOTA_Item_Desc_Frostiron_Raider_Set"	"このバンドルには Tusk 用の 'Frostiron Raider' セット内の全てのアイテムが含まれます："
"[english]DOTA_Item_Desc_Frostiron_Raider_Set"	"This bundle contains all of the items in the 'Frostiron Raider' set for Tusk:"
"DOTA_Item_Desc_Frostiron_Sorceress_Set"	"このバンドルには Crystal Maiden 用の 'Frostiron Sorceress' セット内の全てのアイテムが含まれます："
"[english]DOTA_Item_Desc_Frostiron_Sorceress_Set"	"This bundle contains all of the items in the 'Frostiron Sorceress' set for Crystal Maiden:"
"DOTA_Item_Desc_Gemmed_Armor_of_the_Priest_Kings_Set"	"信仰を信頼しつつも、優れた武装を。 このバンドルには Chen 用の 'Gammed Armor of the Priest Kings' セット内の全てのアイテムが含まれます："
"[english]DOTA_Item_Desc_Gemmed_Armor_of_the_Priest_Kings_Set"	"Trust in faith, but wear good armor.  This bundle contains all of the items in the 'Gemmed Armor of the Priest Kings' set for Chen:"
"DOTA_Item_Forsaken_Beauty_Set"	"Forsaken Beauty セット"
"[english]DOTA_Item_Forsaken_Beauty_Set"	"Forsaken Beauty Set"
"DOTA_Item_Frostiron_Raider_Set"	"Frostiron Raider セット"
"[english]DOTA_Item_Frostiron_Raider_Set"	"Frostiron Raider Set"
"DOTA_Item_Frostiron_Sorceress_Cape"	"Frostiron Sorceress の肩マント"
"[english]DOTA_Item_Frostiron_Sorceress_Cape"	"Frostiron Sorceress Cape"
"DOTA_Item_Frostiron_Sorceress_Set"	"Frostiron Sorceress セット"
"[english]DOTA_Item_Frostiron_Sorceress_Set"	"Frostiron Sorceress Set"
"DOTA_Item_Gemmed_Armor_of_the_Priest_Kings_Set"	"Gemmed Armor of the Priest Kings セット"
"[english]DOTA_Item_Gemmed_Armor_of_the_Priest_Kings_Set"	"Gemmed Armor of the Priest Kings Set"
"DOTA_Item_Lunas_Head"	"Luna の頭部"
"[english]DOTA_Item_Lunas_Head"	"Luna's Head"
"DOTA_Item_Lunas_Helmet"	"Luna の兜"
"[english]DOTA_Item_Lunas_Helmet"	"Luna's Helmet"
"DOTA_Item_Lunas_Mount"	"Luna の乗用動物"
"[english]DOTA_Item_Lunas_Mount"	"Luna's Mount"
"DOTA_Item_Lunas_Shield"	"Luna の盾"
"[english]DOTA_Item_Lunas_Shield"	"Luna's Shield"
"DOTA_Item_Lunas_Shoulder_Armor"	"Luna の肩鎧"
"[english]DOTA_Item_Lunas_Shoulder_Armor"	"Luna's Shoulder Armor"
"DOTA_Item_Lunas_Weapon"	"Luna の武器"
"[english]DOTA_Item_Lunas_Weapon"	"Luna's Weapon"
"DOTA_Item_Abaddons_Shoulder_Armor"	"Abaddon の肩鎧"
"[english]DOTA_Item_Abaddons_Shoulder_Armor"	"Abaddon's Shoulder Armor"
"DOTA_Item_Abaddons_Weapon"	"Abaddon の武器"
"[english]DOTA_Item_Abaddons_Weapon"	"Abaddon's Weapon"
"DOTA_Item_Arms_of_the_Deep_Vault_Guardian_Set"	"Arms of the Deep Vault Guardian セット"
"[english]DOTA_Item_Arms_of_the_Deep_Vault_Guardian_Set"	"Arms of the Deep Vault Guardian Set"
"DOTA_Item_Desc_Acolyte_of_Clasz_Set"	"このバンドルには Faceless Void 用の 'Acolyte of Clasz' セット内の全てのアイテムが含まれます："
"[english]DOTA_Item_Desc_Acolyte_of_Clasz_Set"	"This bundle contains all of the items in the 'Acolyte of Clasz' set for Faceless Void:"
"DOTA_Item_Desc_Copy_of_Abaddons_Cape"	"この新しいアイテムには説明がありません。"
"[english]DOTA_Item_Desc_Copy_of_Abaddons_Cape"	"This new item has no description."
"DOTA_Item_Desc_Copy_of_Abaddons_Helmet"	"この新しいアイテムには説明がありません。"
"[english]DOTA_Item_Desc_Copy_of_Abaddons_Helmet"	"This new item has no description."
"DOTA_Item_Desc_Copy_of_Abaddons_Shoulder_Armor"	"この新しいアイテムには説明がありません。"
"[english]DOTA_Item_Desc_Copy_of_Abaddons_Shoulder_Armor"	"This new item has no description."
"DOTA_Item_Desc_Copy_of_Abaddons_Weapon"	"この新しいアイテムには説明がありません。"
"[english]DOTA_Item_Desc_Copy_of_Abaddons_Weapon"	"This new item has no description."
"DOTA_Item_Desc_Regalia_of_the_Bonelord_Set"	"このバンドルには Skeleton King 用の 'Regalia of the Bonelord' セット内の全てのアイテムが含まれます："
"[english]DOTA_Item_Desc_Regalia_of_the_Bonelord_Set"	"This bundle contains all of the items in the 'Regalia of the Bonelord' set for Wraith King:"
"DOTA_Item_Desc_The_Garments_of_the_Charred_Bloodline_Set"	"このバンドルには Lina 用の 'Garments of the Charred Bloodline' セット内の全てのアイテムが含まれます："
"[english]DOTA_Item_Desc_The_Garments_of_the_Charred_Bloodline_Set"	"This bundle contains all of the items in the 'Garments of the Charred Bloodline' set for Lina:"
"DOTA_Item_Desc_The_Red_Conqueror_Set"	"このバンドルには Axe 用の 'Red Conqueror' セット内の全てのアイテムが含まれます："
"[english]DOTA_Item_Desc_The_Red_Conqueror_Set"	"This bundle contains all of the items in the 'Red Conqueror' set for Axe:"
"DOTA_Item_Gunslingers_Cape"	"Gunslinger の肩マント"
"[english]DOTA_Item_Gunslingers_Cape"	"Gunslinger's Cape"
"DOTA_Item_Nightwatchers_Set"	"Nightwatchers セット"
"[english]DOTA_Item_Nightwatchers_Set"	"Nightwatchers Set"
"DOTA_Item_Regalia_of_the_Bonelord_Set"	"Regalia of the Bonelord セット"
"[english]DOTA_Item_Regalia_of_the_Bonelord_Set"	"Regalia of the Bonelord Set"
"DOTA_Item_Remains_of_the_Dreadknight_Set"	"Remains of the Dreadknight セット"
"[english]DOTA_Item_Remains_of_the_Dreadknight_Set"	"Remains of the Dreadknight Set"
"DOTA_Item_Treasure_Key_of_Incandescent_Wax"	"Incandescent Wax 宝箱の鍵"
"[english]DOTA_Item_Treasure_Key_of_Incandescent_Wax"	"Treasure Key of Incandescent Wax"
"DOTA_WearableType_Treasure_Key"	"宝箱の鍵"
"[english]DOTA_WearableType_Treasure_Key"	"Treasure Key"
"DOTA_Item_Defense_Grid_Announcer_Pack"	"Defense Grid アナウンサーパック"
"[english]DOTA_Item_Defense_Grid_Announcer_Pack"	"Defense Grid Announcer Pack"
"DOTA_Item_Claddish_Voyagers_Chestplate"	"Claddish Voyager の胸当て"
"[english]DOTA_Item_Claddish_Voyagers_Chestplate"	"Claddish Voyager's Chestplate"
"DOTA_Item_Claddish_Voyagers_Gloves"	"Claddish Voyager の手袋"
"[english]DOTA_Item_Claddish_Voyagers_Gloves"	"Claddish Voyager's Gloves"
"DOTA_Item_Claddish_Voyagers_Helm"	"Claddish Voyager の兜"
"[english]DOTA_Item_Claddish_Voyagers_Helm"	"Claddish Voyager's Helm"
"DOTA_Item_Armory_Expander"	"保管庫拡張"
"[english]DOTA_Item_Armory_Expander"	"Armory Expander"
"DOTA_Item_Desc_Armory_Expander"	"このツールを使用して保管庫を120スロット分拡張します。保管庫拡張は使用すると消費されます。"
"[english]DOTA_Item_Desc_Armory_Expander"	"Use this tool to add 120 slots to your armory. Armory Expanders are consumable items that may only be used once."
"DOTA_Item_Desc_Essence_of_Magic"	"Exort, Wex, とQuas の混合エネルギーを含む結晶"
"[english]DOTA_Item_Desc_Essence_of_Magic"	"A crystal containing the combined energies of Exort, Wex, and Quas."
"DOTA_Item_Desc_Recipe_Dire_Reward"	"このレシピはいくつかの魔法のエッセンスを合わせてランダムなアイテム1つを作り出します。"
"[english]DOTA_Item_Desc_Recipe_Dire_Reward"	"This recipe will combine a number of magical essences and produce a random item."
"DOTA_Item_Desc_Recipe_Materialize_Item"	"このレシピはいくつかの魔法のエッセンスを合わせてランダムなアイテム1つを作り出します。"
"[english]DOTA_Item_Desc_Recipe_Materialize_Item"	"This recipe will combine a number of magical essences and produce a random item."
"DOTA_WearableType_Frosty_Pro_Gear_Bundle"	"Frosty プロギアバンドル"
"[english]DOTA_WearableType_Frosty_Pro_Gear_Bundle"	"Frosty Pro Gear Bundle"
"DOTA_Item_Desc_Recipe_Unusual_Artificers_Hammer"	"このレシピは複数のアイテムを組み合わせて Unusual Artificer's Hammer を一つ作成します。"
"[english]DOTA_Item_Desc_Recipe_Unusual_Artificers_Hammer"	"This recipe will combine a number of items and produce an Unusual Artificer's Hammer."
"DOTA_Item_Recipe_Unusual_Artificers_Hammer"	"レシピ： Unusual Artificer's Hammer"
"[english]DOTA_Item_Recipe_Unusual_Artificers_Hammer"	"Recipe: Unusual Artificer's Hammer"
"DOTA_Item_Unusual_Artificers_Hammer"	"Unusual Artificer's Hammer"
"[english]DOTA_Item_Unusual_Artificers_Hammer"	"Unusual Artificer's Hammer"
"DOTA_Item_Desc_Frosty_Treasure_of_Frostivus"	"この宝箱を開けるには<font color='#9da1a9'>Frostivus 2013 宝箱の鍵</font>が必要です。DOTA 2ストアで販売されています。<font color='#9da1a9'>2014年1月12日</font>にこの宝箱は無価値な雪の結晶に変わるのでご注意ください。この宝箱の中にはミステリアスの新アイテムが含まれています："
"[english]DOTA_Item_Desc_Frosty_Treasure_of_Frostivus"	"You will need <font color='#9da1a9'>Frostivus 2013 Treasure Key</font> to open this chest. You can pick one up at the DOTA 2 Store. Beware! At the end of <font color='#9da1a9'>January 12, 2014</font> this chest will crumble into useless snowflakes. This chest contains one of several mysterious new items:"
"DOTA_Item_Desc_Shining_Booster_500_minutes"	"Wraith-Night にこのアイテムを使用すると輝く破片を獲得できる。輝く破片はWraith-Night Ossuaries と交換できる。
<br><br>
光輝ブースターの時間Wraith-Night をプレイしたときにのみ消費され、各仲間にはスタッカブルな10%のボーナスが付きます。 ゲーム観戦や、コーチングで消費されることはありません。"
"[english]DOTA_Item_Desc_Shining_Booster_500_minutes"	"Use this item to earn Shining Fragments in Wraith-Night. Shining Fragments can be redemeed for Wraith-Night Ossuaries.
	<br><br>
	Shining Booster minutes are only consumed when you play Wraith-Night and will grant a 10% stackable bonus to each of your cohorts. Features like spectating games or coaching do not deplete them."
"DOTA_Item_Desc_Welcoming_Chest"	"謎めいた中身の入った宝箱。開けるにはウェルカム宝箱の鍵を使用する必要があります。"
"[english]DOTA_Item_Desc_Welcoming_Chest"	"A treasure chest with mysterious contents. You must use a Welcoming Chest Key to open this."
"DOTA_Item_Desc_Welcoming_Chest_Key"	"鍵のかかった<font color='#9da1a9'>ウェルカム宝箱</font>を開けるのに使用。保管庫内の鍵をダブルクリックか右クリックして、開けたい宝箱を選択しよう。"
"[english]DOTA_Item_Desc_Welcoming_Chest_Key"	"Used to open the locked <font color='#9da1a9'>Welcoming Chest</font>. Double click or right-click the key in your backpack and select the chest you want to open."
"DOTA_Item_Desc_WraithNight_Ossuary"	"王からのユニークなギフト。Wraith-Night Ossuaries は輝く破片でのみ入手可。輝く破片は光輝ブースターを有効化すると獲得できる。"
"[english]DOTA_Item_Desc_WraithNight_Ossuary"	"A unique gift from the King. Wraith-Night Ossuaries can only be acquired with Shining Fragments.  Shining Fragments are earned by activiting a Wraith King's Favor."
"DOTA_Item_Shining_Booster_500_minutes"	"光輝ブースター（500分）"
"[english]DOTA_Item_Shining_Booster_500_minutes"	"Shining Booster (500 minutes)"
"DOTA_Item_Welcoming_Chest"	"ウェルカム宝箱"
"[english]DOTA_Item_Welcoming_Chest"	"Welcoming Chest"
"DOTA_Item_Welcoming_Chest_Key"	"ウェルカム宝箱の鍵"
"[english]DOTA_Item_Welcoming_Chest_Key"	"Welcoming Chest Key"
"DOTA_Item_WraithNight_Offering"	"Wraith-Night 捧げ物"
"[english]DOTA_Item_WraithNight_Offering"	"Wraith-Night Offering"
"DOTA_WearableType_Shining_Booster"	"光輝ブースター"
"[english]DOTA_WearableType_Shining_Booster"	"Shining Booster"
}
}
