"lang"
{
"Language"	"spanish"
"Tokens"
{
"Tutorial.NPXDEM_1"	"En Dota, dos equipos se enfrentan entre sí en un vasto campo de batalla.\nCada uno de los equipos, llamados Radiant y Dire, está compuesto por 5 jugadores.\nAquel equipo capaz de destruir la Fortaleza Ancestral del oponente se alzará con la victoria."
"[english]Tutorial.NPXDEM_1"	"In Dota, two teams face each other across a vast battlefield.\nThe teams, called Radiant and Dire, are each made up of 5 players.\nWhichever team is able to destroy the opposing team's Ancient will claim victory."
"Tutorial.NPXDEM_2"	"Dispersos por el campo de batalla hay varios lugares importantes.\nDesde junglas infestadas de monstruos hasta el río, que separa los territorios iniciales de los equipos."
"[english]Tutorial.NPXDEM_2"	"Across the battlefield are scattered a number of important locations.\nFrom monster infested jungles to the river, which divides the team's starting territories."
"Tutorial.NPXDEM_3"	"Al comienzo de la partida, cada jugador elige un héroe de una plantilla variada,\ny luego gasta su oro inicial en unos cuantos objetos asequibles."
"[english]Tutorial.NPXDEM_3"	"As the match begins, each player chooses a Hero from a diverse roster,\nand then spends their starting gold on a handful of inexpensive items."
"Tutorial.NPXDEM_4"	"Dentro de cada base hay tres pares de barracones, desde los que surgen unidades incontrolables llamadas creeps.\nEstos creeps avanzan por una de las tres sendas hacia la base enemiga."
"[english]Tutorial.NPXDEM_4"	"Within each Base are three sets of Barracks, where uncontrollable units called Creeps march forth.\nThese Creeps progress down one of the three lanes toward the enemy Base."
"Tutorial.NPXDEM_5"	"Cada senda está protegida por tres torres defensivas, que atacarán a los creeps o héroes que se acerquen.\nEn las fases iniciales de la batalla, los héroes todavía tienen que reunir fuerzas y precisan\nviajar con sus creeps para protegerse de creeps y otras fuerzas enemigas."
"[english]Tutorial.NPXDEM_5"	"Each lane is protected by three defensive Towers, which will attack advancing Creeps or Heroes.\nIn the early stages of battle, Heroes have yet to gather their strength, and may wish\nto travel with their Creeps for protection from enemy Creeps and other forces."
"Tutorial.NPXDEM_6"	"A medida que avanza la batalla, los héroes matan a creeps y héroes enemigos para obtener oro y experiencia.\nEsto les permite obtener poder y empezar a asaltar las torres defensivas exteriores del equipo enemigo."
"[english]Tutorial.NPXDEM_6"	"As the battle continues, Heroes kill enemy Creeps and enemy Heroes to gain gold and experience.\nThis will allow them to gain power and begin assaulting the enemy Team's outer defensive Towers."
"Tutorial.NPXDEM_8"	"El río es el origen de las runas. Las runas proporcionan bonificaciones temporales, pero poderosas."
"[english]Tutorial.NPXDEM_8"	"The river is the source of Runes. Runes provide temporary, but powerful bonuses."
"Tutorial.NPXDEM_9"	"A veces los héroes consideran que es más seguro atacar a creeps meutrales en la jungla,\no puede que unan fuerzas para atacar al poderoso Roshan en su guarida, esperando conseguir\nsu Protección del Inmortal."
"[english]Tutorial.NPXDEM_9"	"Heroes might sometimes find it safer to attack Neutral Creeps in the jungles,\nor they may gather to assault the mighty Roshan in his lair, hoping to harvest\nhis resurrecting Aegis of Immortality."
"Tutorial.NPXDEM_10"	"Con el tiempo, un equipo se volverá lo suficientemente fuerte como para avanzar hacia la base enemiga,\ndonde podrán destruir barracones enemigos para obtener mega creeps en esa senda."
"[english]Tutorial.NPXDEM_10"	"In time, a Team will become powerful enough to advance their forces into the enemy Base,\nwhere they may destroy the enemy Barracks to grant themselves Mega-Creeps in that lane."
"Tutorial.NPXDEM_11"	"Una vez que hayan atravesado las defensas internas del enemigo,\nel equipo deberá atacar y destruir la Fortaleza Ancestral para alzarse con la victoria."
"[english]Tutorial.NPXDEM_11"	"Once they have breached the enemy's inner defenses,\nthe Team must attack and destroy the Ancient to claim victory."
}
}
