"lang"
{
"Language"	"dutch"
"Tokens"
{
"announcer_killing_spree_announcer_kill_double_01"	"Dubbele kill!"
"[english]announcer_killing_spree_announcer_kill_double_01"	"Double kill!"
"announcer_killing_spree_announcer_kill_triple_01"	"Driedubbele kill!"
"[english]announcer_killing_spree_announcer_kill_triple_01"	"Triple kill!"
"announcer_killing_spree_announcer_kill_ultra_01"	"Ultra kill!"
"[english]announcer_killing_spree_announcer_kill_ultra_01"	"Ultra kill!"
"announcer_killing_spree_announcer_kill_dominate_01"	"Overheersend!"
"[english]announcer_killing_spree_announcer_kill_dominate_01"	"Dominating!"
"announcer_killing_spree_announcer_kill_mega_01"	"Mega kill!"
"[english]announcer_killing_spree_announcer_kill_mega_01"	"Mega kill!"
"announcer_killing_spree_announcer_kill_unstop_01"	"Niet te stoppen!"
"[english]announcer_killing_spree_announcer_kill_unstop_01"	"Unstoppable!"
"announcer_killing_spree_announcer_kill_godlike_01"	"Goddelijk!"
"[english]announcer_killing_spree_announcer_kill_godlike_01"	"Godlike!"
"announcer_killing_spree_announcer_kill_holy_01"	"Krijg nou wat!"
"[english]announcer_killing_spree_announcer_kill_holy_01"	"Holy shit!"
"announcer_killing_spree_announcer_1stblood_01"	"Eerste slachtoffer!"
"[english]announcer_killing_spree_announcer_1stblood_01"	"First blood!"
"announcer_killing_spree_announcer_ownage_01"	"Gedomineerd!"
"[english]announcer_killing_spree_announcer_ownage_01"	"Ownage!"
}
}
