"lang"
{
"Language"	"dutch"
"Tokens"
{
"announcer_announcer_welcome_01"	"Welkom bij Dota!"
"[english]announcer_announcer_welcome_01"	"Welcome to Dota!"
"announcer_announcer_pick_yr"	"Jullie beurt om te kiezen."
"[english]announcer_announcer_pick_yr"	"Your turn to pick."
"announcer_announcer_pick_enm"	"De vijand mag kiezen."
"[english]announcer_announcer_pick_enm"	"Enemy's turn to pick."
"announcer_announcer_pick_rad"	"Radiant mag kiezen."
"[english]announcer_announcer_pick_rad"	"Radiant team pick."
"announcer_announcer_pick_dire"	"Dire mag kiezen."
"[english]announcer_announcer_pick_dire"	"Dire team pick."
"announcer_announcer_ban_yr"	"Jullie beurt om te verbannen."
"[english]announcer_announcer_ban_yr"	"Your turn to ban."
"announcer_announcer_ban_enm"	"De vijand mag verbannen."
"[english]announcer_announcer_ban_enm"	"Enemy's turn to ban."
"announcer_announcer_ban_dire"	"Dire heeft een held verbannen."
"[english]announcer_announcer_ban_dire"	"Dire team ban."
"announcer_announcer_ban_rad"	"Radiant heeft een held verbannen."
"[english]announcer_announcer_ban_rad"	"Radiant team ban."
"announcer_announcer_team_complete_dire"	"Het team van de Dire is compleet."
"[english]announcer_announcer_team_complete_dire"	"Dire's team is complete."
"announcer_announcer_team_complete_rad"	"Het team van de Radiant is compleet."
"[english]announcer_announcer_team_complete_rad"	"Radiant's team is complete."
"announcer_announcer_team_complete_yr"	"Je team is compleet."
"[english]announcer_announcer_team_complete_yr"	"Your team is complete."
"announcer_announcer_team_complete_our"	"Ons team is compleet."
"[english]announcer_announcer_team_complete_our"	"Our team is complete."
"announcer_announcer_now_select"	"Jullie kunnen nu jullie helden kiezen."
"[english]announcer_announcer_now_select"	"You may now select your heroes."
"announcer_announcer_choose_hero"	"Kies je held."
"[english]announcer_announcer_choose_hero"	"Choose your hero."
"announcer_announcer_time_reserve"	"Reservetijd."
"[english]announcer_announcer_time_reserve"	"Reserve time."
"announcer_announcer_count_pick_10"	"Tien seconden te gaan."
"[english]announcer_announcer_count_pick_10"	"Ten seconds remaining."
"announcer_announcer_count_pick_5"	"Vijf seconden te gaan."
"[english]announcer_announcer_count_pick_5"	"Five seconds remaining."
"announcer_announcer_count_battle_30"	"Dertig seconden tot de strijd."
"[english]announcer_announcer_count_battle_30"	"Thirty seconds to battle."
"announcer_announcer_count_battle_10"	"Tien seconden tot de strijd."
"[english]announcer_announcer_count_battle_10"	"Ten seconds to battle."
"announcer_announcer_battle_prepare_01"	"Bereid je voor op de strijd."
"[english]announcer_announcer_battle_prepare_01"	"Prepare for battle."
"announcer_announcer_battle_begin_01"	"De strijd begint!"
"[english]announcer_announcer_battle_begin_01"	"The battle begins!"
"announcer_announcer_anc_attack_yr"	"Je Ancient wordt aangevallen."
"[english]announcer_announcer_anc_attack_yr"	"Your ancient is under attack."
"announcer_announcer_anc_attack_rad"	"De Ancient van Radiant wordt aangevallen."
"[english]announcer_announcer_anc_attack_rad"	"Radiant's ancient is under attack."
"announcer_announcer_anc_attack_dire"	"De Ancient van Dire wordt aangevallen."
"[english]announcer_announcer_anc_attack_dire"	"Dire's ancient is under attack."
"announcer_announcer_twr_attack_rad_top"	"De bovenste toren van de Radiant wordt aangevallen."
"[english]announcer_announcer_twr_attack_rad_top"	"Radiant's top tower is under attack."
"announcer_announcer_twr_attack_rad_mid"	"De middelste toren van de Radiant wordt aangevallen."
"[english]announcer_announcer_twr_attack_rad_mid"	"Radiant's middle tower is under attack."
"announcer_announcer_twr_attack_rad_bot"	"De onderste toren van de Radiant wordt aangevallen."
"[english]announcer_announcer_twr_attack_rad_bot"	"Radiant's bottom tower is under attack."
"announcer_announcer_twr_attack_dire_top"	"De bovenste toren van de Dire wordt aangevallen."
"[english]announcer_announcer_twr_attack_dire_top"	"Dire's top tower is under attack."
"announcer_announcer_twr_attack_dire_mid"	"De middelste toren van de Dire wordt aangevallen."
"[english]announcer_announcer_twr_attack_dire_mid"	"Dire's middle tower is under attack."
"announcer_announcer_twr_attack_dire_bot"	"De onderste toren van de Dire wordt aangevallen."
"[english]announcer_announcer_twr_attack_dire_bot"	"Dire's bottom tower is under attack."
"announcer_announcer_twr_attack_yr_top"	"Je bovenste toren wordt aangevallen."
"[english]announcer_announcer_twr_attack_yr_top"	"Your top tower is under attack."
"announcer_announcer_twr_attack_yr_mid"	"Je middelste toren wordt aangevallen."
"[english]announcer_announcer_twr_attack_yr_mid"	"Your middle tower is under attack."
"announcer_announcer_twr_attack_yr_bot"	"Je onderste toren wordt aangevallen."
"[english]announcer_announcer_twr_attack_yr_bot"	"Your bottom tower is under attack."
"announcer_announcer_twr_fall_yr_top"	"Je bovenste toren is vernietigd."
"[english]announcer_announcer_twr_fall_yr_top"	"Your top tower has fallen."
"announcer_announcer_twr_fall_yr_mid"	"Je middelste toren is vernietigd."
"[english]announcer_announcer_twr_fall_yr_mid"	"Your middle tower has fallen."
"announcer_announcer_twr_fall_yr_bot"	"Je onderste toren is vernietigd."
"[english]announcer_announcer_twr_fall_yr_bot"	"Your bottom tower has fallen."
"announcer_announcer_twr_fall_rad_top"	"De bovenste toren van de Radiant is vernietigd."
"[english]announcer_announcer_twr_fall_rad_top"	"Radiant's top tower has fallen."
"announcer_announcer_twr_fall_rad_mid"	"De middelste toren van de Radiant is vernietigd."
"[english]announcer_announcer_twr_fall_rad_mid"	"Radiant's middle tower has fallen."
"announcer_announcer_twr_fall_rad_bot"	"De onderste toren van de Radiant is vernietigd."
"[english]announcer_announcer_twr_fall_rad_bot"	"Radiant's bottom tower has fallen."
"announcer_announcer_twr_fall_dire_top"	"De bovenste toren van de Dire is vernietigd."
"[english]announcer_announcer_twr_fall_dire_top"	"Dire's top tower has fallen."
"announcer_announcer_twr_fall_dire_mid"	"De middelste toren van de Dire is vernietigd."
"[english]announcer_announcer_twr_fall_dire_mid"	"Dire's middle tower has fallen."
"announcer_announcer_twr_fall_dire_bot"	"De onderste toren van de Dire is vernietigd."
"[english]announcer_announcer_twr_fall_dire_bot"	"Dire's bottom tower has fallen."
"announcer_announcer_twr_fall_enm_top"	"De bovenste toren van de vijand is vernietigd."
"[english]announcer_announcer_twr_fall_enm_top"	"The enemy's top tower has fallen."
"announcer_announcer_twr_fall_enm_mid"	"De middelste toren van de vijand is vernietigd."
"[english]announcer_announcer_twr_fall_enm_mid"	"The enemy's middle tower has fallen."
"announcer_announcer_twr_fall_enm_bot"	"De onderste toren van de vijand is vernietigd."
"[english]announcer_announcer_twr_fall_enm_bot"	"The enemy's bottom tower has fallen."
"announcer_announcer_rax_attack_yr_top"	"Je bovenste barakken worden aangevallen."
"[english]announcer_announcer_rax_attack_yr_top"	"Your top barracks are under attack."
"announcer_announcer_rax_attack_yr_mid"	"Je middelste barakken worden aangevallen."
"[english]announcer_announcer_rax_attack_yr_mid"	"Your middle barracks are under attack."
"announcer_announcer_rax_attack_yr_bot"	"Je onderste barakken worden aangevallen."
"[english]announcer_announcer_rax_attack_yr_bot"	"Your bottom barracks are under attack."
"announcer_announcer_rax_attack_rad_top"	"De bovenste barakken van de Radiant worden aangevallen."
"[english]announcer_announcer_rax_attack_rad_top"	"Radiant's top barracks are under attack."
"announcer_announcer_rax_attack_rad_mid"	"De middelste barakken van de Radiant worden aangevallen."
"[english]announcer_announcer_rax_attack_rad_mid"	"Radiant's middle barracks are under attack."
"announcer_announcer_rax_attack_rad_bot"	"De onderste barakken van de Radiant worden aangevallen."
"[english]announcer_announcer_rax_attack_rad_bot"	"Radiant's bottom barracks are under attack."
"announcer_announcer_rax_attack_dire_top"	"De bovenste barakken van de Dire worden aangevallen."
"[english]announcer_announcer_rax_attack_dire_top"	"Dire's top barracks are under attack."
"announcer_announcer_rax_attack_dire_mid"	"De middelste barakken van de Dire worden aangevallen."
"[english]announcer_announcer_rax_attack_dire_mid"	"Dire's middle barracks are under attack."
"announcer_announcer_rax_attack_dire_bot"	"De onderste barakken van de Dire worden aangevallen."
"[english]announcer_announcer_rax_attack_dire_bot"	"Dire's bottom barracks are under attack."
"announcer_announcer_rax_fall_yr_top"	"Je bovenste barakken zijn vernietigd."
"[english]announcer_announcer_rax_fall_yr_top"	"Your top barracks has fallen."
"announcer_announcer_rax_fall_yr_mid"	"Je middelste barakken zijn vernietigd."
"[english]announcer_announcer_rax_fall_yr_mid"	"Your middle barracks has fallen."
"announcer_announcer_rax_fall_yr_bot"	"Je onderste barakken zijn vernietigd."
"[english]announcer_announcer_rax_fall_yr_bot"	"Your bottom barracks has fallen."
"announcer_announcer_rax_fall_rad_top"	"De bovenste barakken van de Radiant zijn vernietigd."
"[english]announcer_announcer_rax_fall_rad_top"	"Radiant's top barracks has fallen."
"announcer_announcer_rax_fall_rad_mid"	"De middelste barakken van de Radiant zijn vernietigd."
"[english]announcer_announcer_rax_fall_rad_mid"	"Radiant's middle barracks has fallen."
"announcer_announcer_rax_fall_rad_bot"	"De onderste barakken van de Radiant zijn vernietigd."
"[english]announcer_announcer_rax_fall_rad_bot"	"Radiant's bottom barracks has fallen."
"announcer_announcer_rax_fall_dire_top"	"De bovenste barakken van de Dire zijn vernietigd."
"[english]announcer_announcer_rax_fall_dire_top"	"Dire's top barracks has fallen."
"announcer_announcer_rax_fall_dire_mid"	"De middelste barakken van de Dire zijn vernietigd."
"[english]announcer_announcer_rax_fall_dire_mid"	"Dire's middle barracks has fallen."
"announcer_announcer_rax_fall_dire_bot"	"De onderste barakken van de Dire zijn vernietigd."
"[english]announcer_announcer_rax_fall_dire_bot"	"Dire's bottom barracks has fallen."
"announcer_announcer_rax_fall_enm_top"	"De bovenste barakken van de vijand zijn vernietigd."
"[english]announcer_announcer_rax_fall_enm_top"	"The enemy's top barracks has fallen."
"announcer_announcer_rax_fall_enm_mid"	"De middelste barakken van de vijand zijn vernietigd."
"[english]announcer_announcer_rax_fall_enm_mid"	"The enemy's middle barracks has fallen."
"announcer_announcer_rax_fall_enm_bot"	"De onderste barakken van de vijand zijn vernietigd."
"[english]announcer_announcer_rax_fall_enm_bot"	"The enemy's bottom barracks has fallen."
"announcer_announcer_twr_deny_yr_top"	"Je bovenste toren is afgewezen."
"[english]announcer_announcer_twr_deny_yr_top"	"Your top tower has been denied."
"announcer_announcer_twr_deny_yr_mid"	"Je middelste toren is afgewezen."
"[english]announcer_announcer_twr_deny_yr_mid"	"Your middle tower has been denied."
"announcer_announcer_twr_deny_yr_bot"	"Je onderste toren is afgewezen."
"[english]announcer_announcer_twr_deny_yr_bot"	"Your bottom tower has been denied."
"announcer_announcer_twr_deny_enm_top"	"De bovenste toren van de vijand is afgewezen."
"[english]announcer_announcer_twr_deny_enm_top"	"The enemy's top tower has been denied."
"announcer_announcer_twr_deny_enm_mid"	"De middelste toren van de vijand is afgewezen."
"[english]announcer_announcer_twr_deny_enm_mid"	"The enemy's middle tower has been denied."
"announcer_announcer_twr_deny_enm_bot"	"De onderste toren van de vijand is afgewezen."
"[english]announcer_announcer_twr_deny_enm_bot"	"The enemy's bottom tower has been denied."
"announcer_announcer_twr_deny_rad_top"	"De bovenste toren van Radiant is afgewezen."
"[english]announcer_announcer_twr_deny_rad_top"	"Radiant's top tower has been denied."
"announcer_announcer_twr_deny_rad_mid"	"De middelste toren van de Radiant is afgewezen."
"[english]announcer_announcer_twr_deny_rad_mid"	"Radiant's middle tower has been denied."
"announcer_announcer_twr_deny_rad_bot"	"De onderste toren van Radiant is afgewezen."
"[english]announcer_announcer_twr_deny_rad_bot"	"Radiant's bottom tower has been denied."
"announcer_announcer_twr_deny_dire_top"	"De bovenste toren van de Dire is afgewezen."
"[english]announcer_announcer_twr_deny_dire_top"	"Dire's top tower has been denied."
"announcer_announcer_twr_deny_dire_mid"	"De middelste toren van de Dire is afgewezen."
"[english]announcer_announcer_twr_deny_dire_mid"	"Dire's middle tower has been denied."
"announcer_announcer_twr_deny_dire_bot"	"De onderste toren van de Dire is afgewezen."
"[english]announcer_announcer_twr_deny_dire_bot"	"Dire's bottom tower has been denied."
"announcer_announcer_fort_dire"	"De gebouwen van de Dire zijn verstevigd."
"[english]announcer_announcer_fort_dire"	"Dire's structures are fortified."
"announcer_announcer_fort_rad"	"De gebouwen van de Radiant zijn verstevigd."
"[english]announcer_announcer_fort_rad"	"Radiant's structures are fortified."
"announcer_announcer_cour_kill_dire"	"De koerier van de Dire is gedood."
"[english]announcer_announcer_cour_kill_dire"	"Dire's courier has been killed."
"announcer_announcer_cour_kill_rad"	"De koerier van de Radiant is gedood."
"[english]announcer_announcer_cour_kill_rad"	"Radiant's courier has been killed."
"announcer_announcer_mega_now_you"	"Je hebt nu megacreeps."
"[english]announcer_announcer_mega_now_you"	"You now have megacreeps."
"announcer_announcer_mega_now_enm"	"De vijand heeft nu megacreeps."
"[english]announcer_announcer_mega_now_enm"	"The enemy now has megacreeps."
"announcer_announcer_mega_now_dire"	"De Dire heeft nu megacreeps."
"[english]announcer_announcer_mega_now_dire"	"The Dire now have megacreeps."
"announcer_announcer_mega_now_rad"	"De Radiant heeft nu megacreeps."
"[english]announcer_announcer_mega_now_rad"	"The Radiant now have megacreeps."
"announcer_announcer_roshan_fallen_dire"	"Roshan is gedood door de Dire!"
"[english]announcer_announcer_roshan_fallen_dire"	"Roshan has fallen to the Dire!"
"announcer_announcer_roshan_fallen_rad"	"Roshan is gedood door de Radiant!"
"[english]announcer_announcer_roshan_fallen_rad"	"Roshan has fallen to the Radiant!"
"announcer_announcer_victory_dire"	"Dire wint!"
"[english]announcer_announcer_victory_dire"	"Dire victory!"
"announcer_announcer_victory_rad"	"Radiant wint!"
"[english]announcer_announcer_victory_rad"	"Radiant victory!"
"announcer_announcer_type_all_pick"	"Kies een held."
"[english]announcer_announcer_type_all_pick"	"All Pick."
"announcer_announcer_type_all_random"	"Alles willekeurig."
"[english]announcer_announcer_type_all_random"	"All Random."
"announcer_announcer_type_capt_draft"	"Aanvoerderstrekking."
"[english]announcer_announcer_type_capt_draft"	"Captain's Draft."
"announcer_announcer_type_capt_mode"	"Aanvoerdersmodus."
"[english]announcer_announcer_type_capt_mode"	"Captains Mode."
"announcer_announcer_type_random_draft"	"Willekeurige trekking."
"[english]announcer_announcer_type_random_draft"	"Random Draft."
"announcer_announcer_type_single_draft"	"Enkele trekking."
"[english]announcer_announcer_type_single_draft"	"Single Draft."
"announcer_announcer_type_death_match"	"Death Match."
"[english]announcer_announcer_type_death_match"	"Death Match."
"announcer_announcer_type_easy_mode"	"Gemakkelijke modus."
"[english]announcer_announcer_type_easy_mode"	"Easy Mode."
"announcer_announcer_type_rev_capt_mode"	"Omgekeerde aanvoerdersmodus."
"[english]announcer_announcer_type_rev_capt_mode"	"Reverse Captain's Mode."
"announcer_announcer_type_mid_only"	"Alleen midden."
"[english]announcer_announcer_type_mid_only"	"Mid Only."
"announcer_announcer_type_least_played"	"Minst gespeeld."
"[english]announcer_announcer_type_least_played"	"Least Played."
"announcer_announcer_time_extra"	"Bonustijd."
"[english]announcer_announcer_time_extra"	"Extra time."
"announcer_announcer_time_reserve_using"	"Je gebruikt reservetijd."
"[english]announcer_announcer_time_reserve_using"	"You are using Reserve Time."
"announcer_announcer_time_extra_using"	"Je maakt gebruik van de bonustijd."
"[english]announcer_announcer_time_extra_using"	"You are using Extra Time."
"announcer_announcer_alert_disconnection"	"Verbinding verbroken."
"[english]announcer_announcer_alert_disconnection"	"Disconnection."
"announcer_announcer_alert_reconnection"	"Opnieuw verbinden."
"[english]announcer_announcer_alert_reconnection"	"Reconnection."
"announcer_announcer_missing_lane_01"	"Bovenkant is vermist."
"[english]announcer_announcer_missing_lane_01"	"Top is missing."
"announcer_announcer_missing_lane_02"	"Midden is vermist."
"[english]announcer_announcer_missing_lane_02"	"Middle is missing."
"announcer_announcer_missing_lane_03"	"Onder is vermist."
"[english]announcer_announcer_missing_lane_03"	"Bottom is missing."
"announcer_announcer_intl2012_game_01"	"Spel 1."
"[english]announcer_announcer_intl2012_game_01"	"Game 1."
"announcer_announcer_intl2012_game_02"	"Spel 2."
"[english]announcer_announcer_intl2012_game_02"	"Game 2."
"announcer_announcer_intl2012_game_03"	"Spel 3."
"[english]announcer_announcer_intl2012_game_03"	"Game 3."
"announcer_announcer_intl2012_game_04"	"Spel 4"
"[english]announcer_announcer_intl2012_game_04"	"Game 4"
"announcer_announcer_intl2012_game_05"	"Spel 5."
"[english]announcer_announcer_intl2012_game_05"	"Game 5."
"announcer_announcer_intl2012_game_06"	"Laatste spel."
"[english]announcer_announcer_intl2012_game_06"	"Final game."
"announcer_announcer_intl2012_itemgranted_01"	"Je hebt een voorwerp gekregen."
"[english]announcer_announcer_intl2012_itemgranted_01"	"You have been granted an item."
"announcer_announcer_intl2012_itemgranted_02"	"Er is een voorwerp gegeven."
"[english]announcer_announcer_intl2012_itemgranted_02"	"An item has been granted."
"announcer_announcer_intl2012_teamnameban_02"	"Na'Vi mag verbannen."
"[english]announcer_announcer_intl2012_teamnameban_02"	"Na'Vi's turn to ban."
"announcer_announcer_intl2012_teamnameban_03"	"DK mag verbannen."
"[english]announcer_announcer_intl2012_teamnameban_03"	"DK's turn to ban."
"announcer_announcer_intl2012_teamnameban_04"	"Orange mag verbannen."
"[english]announcer_announcer_intl2012_teamnameban_04"	"Orange's turn to ban."
"announcer_announcer_intl2012_teamnameban_06"	"iG mag verbannen."
"[english]announcer_announcer_intl2012_teamnameban_06"	"iG's turn to ban."
"announcer_announcer_intl2012_teamnameban_10"	"Zenith mag verbannen."
"[english]announcer_announcer_intl2012_teamnameban_10"	"Zenith's turn to ban."
"announcer_announcer_intl2012_teamnameban_12"	"LGD mag verbannen."
"[english]announcer_announcer_intl2012_teamnameban_12"	"LGD's turn to ban."
"announcer_announcer_intl2012_teamnameban_15"	"TongFu mag verbannen."
"[english]announcer_announcer_intl2012_teamnameban_15"	"TongFu's turn to ban."
"announcer_announcer_intl2012_teamnameban_17"	"Mousesports mag verbannen."
"[english]announcer_announcer_intl2012_teamnameban_17"	"Mousesports' turn to ban."
"announcer_announcer_intl2013_teamnameban_01"	"Alliance mag verbannen."
"[english]announcer_announcer_intl2013_teamnameban_01"	"Alliance's turn to ban."
"announcer_announcer_intl2013_teamnameban_02"	"Fnatic mag verbannen."
"[english]announcer_announcer_intl2013_teamnameban_02"	"Fnatic's turn to ban."
"announcer_announcer_intl2013_teamnameban_03"	"Team Liquid mag verbannen."
"[english]announcer_announcer_intl2013_teamnameban_03"	"Team Liquid's turn to ban."
"announcer_announcer_intl2013_teamnameban_04"	"Team Dignitas mag verbannen."
"[english]announcer_announcer_intl2013_teamnameban_04"	"Team Dignitas' turn to ban."
"announcer_announcer_intl2013_teamnameban_05"	"Virtus.Pro mag verbannen."
"[english]announcer_announcer_intl2013_teamnameban_05"	"Virtus.Pro's turn to ban."
"announcer_announcer_intl2013_teamnameban_06"	"Invasion MUFC mag verbannen."
"[english]announcer_announcer_intl2013_teamnameban_06"	"Invasion MUFC's turn to ban."
"announcer_announcer_intl2013_teamnameban_08"	"LGD International mag verbannen."
"[english]announcer_announcer_intl2013_teamnameban_08"	"LGD International's turn to ban."
"announcer_announcer_intl2013_teamnameban_11"	"Quantic Gaming mag verbannen."
"[english]announcer_announcer_intl2013_teamnameban_11"	"Quantic Gaming's turn to ban."
"announcer_announcer_intl2013_teamnameban_12"	"RattleSnake mag verbannen."
"[english]announcer_announcer_intl2013_teamnameban_12"	"RattleSnake's turn to ban."
"announcer_announcer_intl2012_teamnameban_01"	"Absolute Legends mag verbannen."
"[english]announcer_announcer_intl2012_teamnameban_01"	"Absolute Legends' turn to ban."
"announcer_announcer_intl2012_teamnameban_05"	"EHOME mag verbannen."
"[english]announcer_announcer_intl2012_teamnameban_05"	"EHOME's turn to ban."
"announcer_announcer_intl2012_teamnameban_07"	"compLexity mag verbannen."
"[english]announcer_announcer_intl2012_teamnameban_07"	"compLexity's turn to ban."
"announcer_announcer_intl2012_teamnameban_08"	"CLG mag verbannen."
"[english]announcer_announcer_intl2012_teamnameban_08"	"CLG's turn to ban."
"announcer_announcer_intl2012_teamnameban_09"	"EG mag verbannen."
"[english]announcer_announcer_intl2012_teamnameban_09"	"EG's turn to ban."
"announcer_announcer_intl2012_teamnameban_11"	"Darer mag verbannen."
"[english]announcer_announcer_intl2012_teamnameban_11"	"Darer's turn to ban."
"announcer_announcer_intl2012_teamnameban_13"	"MUFC mag verbannen."
"[english]announcer_announcer_intl2012_teamnameban_13"	"MUFC's turn to ban."
"announcer_announcer_intl2012_teamnameban_14"	"mTw mag verbannen."
"[english]announcer_announcer_intl2012_teamnameban_14"	"mTw's turn to ban."
"announcer_announcer_intl2012_teamnameban_16"	"World Elite mag verbannen."
"[english]announcer_announcer_intl2012_teamnameban_16"	"World Elite's turn to ban."
"announcer_announcer_intl2012_teamnameban_18"	"Moscow Five mag verbannen."
"[english]announcer_announcer_intl2012_teamnameban_18"	"Moscow Five's turn to ban."
"announcer_announcer_intl2013_teamnameban_07"	"LGD mag verbannen."
"[english]announcer_announcer_intl2013_teamnameban_07"	"LGD's turn to ban."
"announcer_announcer_intl2013_teamnameban_09"	"LGD Cn mag verbannen."
"[english]announcer_announcer_intl2013_teamnameban_09"	"LGD Cn's turn to ban."
"announcer_announcer_intl2013_teamnameban_10"	"LGD Imposter mag verbannen."
"[english]announcer_announcer_intl2013_teamnameban_10"	"LGD Imposter's turn to ban."
"announcer_announcer_intl2012_teamnamepick_02"	"Na'Vi mag kiezen."
"[english]announcer_announcer_intl2012_teamnamepick_02"	"Na'Vi's turn to pick."
"announcer_announcer_intl2012_teamnamepick_03"	"DK mag kiezen."
"[english]announcer_announcer_intl2012_teamnamepick_03"	"DK's turn to pick."
"announcer_announcer_intl2012_teamnamepick_04"	"Orange mag kiezen."
"[english]announcer_announcer_intl2012_teamnamepick_04"	"Orange's turn to pick."
"announcer_announcer_intl2012_teamnamepick_06"	"iG mag kiezen."
"[english]announcer_announcer_intl2012_teamnamepick_06"	"iG's turn to pick."
"announcer_announcer_intl2012_teamnamepick_10"	"Zenith mag kiezen."
"[english]announcer_announcer_intl2012_teamnamepick_10"	"Zenith's turn to pick."
"announcer_announcer_intl2012_teamnamepick_12"	"LGD mag kiezen."
"[english]announcer_announcer_intl2012_teamnamepick_12"	"LGD's turn to pick."
"announcer_announcer_intl2012_teamnamepick_15"	"TongFu mag kiezen."
"[english]announcer_announcer_intl2012_teamnamepick_15"	"TongFu's turn to pick."
"announcer_announcer_intl2012_teamnamepick_17"	"Mousesports mag kiezen."
"[english]announcer_announcer_intl2012_teamnamepick_17"	"Mousesports' turn to pick."
"announcer_announcer_intl2013_teamnamepick_01"	"Alliance mag kiezen."
"[english]announcer_announcer_intl2013_teamnamepick_01"	"Alliance's turn to pick."
"announcer_announcer_intl2013_teamnamepick_02"	"Fnatic mag kiezen."
"[english]announcer_announcer_intl2013_teamnamepick_02"	"Fnatic's turn to pick."
"announcer_announcer_intl2013_teamnamepick_03"	"Team Liquid mag kiezen."
"[english]announcer_announcer_intl2013_teamnamepick_03"	"Team Liquid's turn to pick."
"announcer_announcer_intl2013_teamnamepick_04"	"Team Dignitas mag kiezen."
"[english]announcer_announcer_intl2013_teamnamepick_04"	"Team Dignitas' turn to pick."
"announcer_announcer_intl2013_teamnamepick_05"	"Virtus.Pro mag kiezen."
"[english]announcer_announcer_intl2013_teamnamepick_05"	"Virtus.Pro's turn to pick."
"announcer_announcer_intl2013_teamnamepick_06"	"Invasion MUFC mag kiezen."
"[english]announcer_announcer_intl2013_teamnamepick_06"	"Invasion MUFC's turn to pick."
"announcer_announcer_intl2013_teamnamepick_08"	"LGD International mag kiezen."
"[english]announcer_announcer_intl2013_teamnamepick_08"	"LGD International's turn to pick."
"announcer_announcer_intl2013_teamnamepick_11"	"Quantic Gaming mag kiezen."
"[english]announcer_announcer_intl2013_teamnamepick_11"	"Quantic Gaming's turn to pick."
"announcer_announcer_intl2013_teamnamepick_12"	"RattleSnake mag kiezen."
"[english]announcer_announcer_intl2013_teamnamepick_12"	"RattleSnake's turn to pick."
"announcer_announcer_intl2012_teamnamepick_01"	"Absolute Legends mag kiezen."
"[english]announcer_announcer_intl2012_teamnamepick_01"	"Absolute Legends' turn to pick."
"announcer_announcer_intl2012_teamnamepick_05"	"EHOME mag kiezen."
"[english]announcer_announcer_intl2012_teamnamepick_05"	"EHOME's turn to pick."
"announcer_announcer_intl2012_teamnamepick_07"	"compLexity mag kiezen."
"[english]announcer_announcer_intl2012_teamnamepick_07"	"compLexity's turn to pick."
"announcer_announcer_intl2012_teamnamepick_08"	"CLG mag kiezen."
"[english]announcer_announcer_intl2012_teamnamepick_08"	"CLG's turn to pick."
"announcer_announcer_intl2012_teamnamepick_09"	"EG mag kiezen."
"[english]announcer_announcer_intl2012_teamnamepick_09"	"EG's turn to pick."
"announcer_announcer_intl2012_teamnamepick_11"	"Darer mag kiezen."
"[english]announcer_announcer_intl2012_teamnamepick_11"	"Darer's turn to pick."
"announcer_announcer_intl2012_teamnamepick_13"	"MUFC mag kiezen."
"[english]announcer_announcer_intl2012_teamnamepick_13"	"MUFC's turn to pick."
"announcer_announcer_intl2012_teamnamepick_14"	"mTw mag kiezen."
"[english]announcer_announcer_intl2012_teamnamepick_14"	"mTw's turn to pick."
"announcer_announcer_intl2012_teamnamepick_16"	"World Elite mag kiezen."
"[english]announcer_announcer_intl2012_teamnamepick_16"	"World Elite's turn to pick."
"announcer_announcer_intl2012_teamnamepick_18"	"Moscow Five mag kiezen."
"[english]announcer_announcer_intl2012_teamnamepick_18"	"Moscow Five's turn to pick."
"announcer_announcer_intl2013_teamnamepick_07"	"LGD mag kiezen."
"[english]announcer_announcer_intl2013_teamnamepick_07"	"LGD's turn to pick."
"announcer_announcer_intl2013_teamnamepick_09"	"LGD Cn mag kiezen."
"[english]announcer_announcer_intl2013_teamnamepick_09"	"LGD Cn's turn to pick."
"announcer_announcer_intl2013_teamnamepick_10"	"LGD Imposter mag kiezen."
"[english]announcer_announcer_intl2013_teamnamepick_10"	"LGD Imposter's turn to pick."
"announcer_announcer_intl2012_teamnames_01"	"aL "
"[english]announcer_announcer_intl2012_teamnames_01"	"aL"
"announcer_announcer_intl2012_teamnames_02"	"Absolute Legends "
"[english]announcer_announcer_intl2012_teamnames_02"	"Absolute Legends"
"announcer_announcer_intl2012_teamnames_03"	"Na'Vi "
"[english]announcer_announcer_intl2012_teamnames_03"	"Na'Vi"
"announcer_announcer_intl2012_teamnames_04"	"Natus Vincere "
"[english]announcer_announcer_intl2012_teamnames_04"	"Natus Vincere"
"announcer_announcer_intl2012_teamnames_05"	"DK "
"[english]announcer_announcer_intl2012_teamnames_05"	"DK"
"announcer_announcer_intl2012_teamnames_06"	"Orange "
"[english]announcer_announcer_intl2012_teamnames_06"	"Orange"
"announcer_announcer_intl2012_teamnames_07"	"EHOME "
"[english]announcer_announcer_intl2012_teamnames_07"	"EHOME"
"announcer_announcer_intl2012_teamnames_08"	"iG "
"[english]announcer_announcer_intl2012_teamnames_08"	"iG"
"announcer_announcer_intl2012_teamnames_09"	"Invictus Gaming "
"[english]announcer_announcer_intl2012_teamnames_09"	"Invictus Gaming"
"announcer_announcer_intl2012_teamnames_10"	"coL "
"[english]announcer_announcer_intl2012_teamnames_10"	"coL"
"announcer_announcer_intl2012_teamnames_11"	"compLexity "
"[english]announcer_announcer_intl2012_teamnames_11"	"compLexity"
"announcer_announcer_intl2012_teamnames_12"	"CLG "
"[english]announcer_announcer_intl2012_teamnames_12"	"CLG"
"announcer_announcer_intl2012_teamnames_13"	"Counter Logic Gaming "
"[english]announcer_announcer_intl2012_teamnames_13"	"Counter Logic Gaming"
"announcer_announcer_intl2012_teamnames_14"	"EG "
"[english]announcer_announcer_intl2012_teamnames_14"	"EG"
"announcer_announcer_intl2012_teamnames_15"	"Evil Geniuses "
"[english]announcer_announcer_intl2012_teamnames_15"	"Evil Geniuses"
"announcer_announcer_intl2012_teamnames_16"	"Zenith"
"[english]announcer_announcer_intl2012_teamnames_16"	"Zenith"
"announcer_announcer_intl2012_teamnames_17"	"Darer"
"[english]announcer_announcer_intl2012_teamnames_17"	"Darer"
"announcer_announcer_intl2012_teamnames_18"	"LGD"
"[english]announcer_announcer_intl2012_teamnames_18"	"LGD"
"announcer_announcer_intl2012_teamnames_19"	"MUFC"
"[english]announcer_announcer_intl2012_teamnames_19"	"MUFC"
"announcer_announcer_intl2012_teamnames_20"	"M5"
"[english]announcer_announcer_intl2012_teamnames_20"	"M5"
"announcer_announcer_intl2012_teamnames_21"	"Moscow Five"
"[english]announcer_announcer_intl2012_teamnames_21"	"Moscow Five"
"announcer_announcer_intl2012_teamnames_22"	"mTw"
"[english]announcer_announcer_intl2012_teamnames_22"	"mTw"
"announcer_announcer_intl2012_teamnames_23"	"Mortal Teamwork"
"[english]announcer_announcer_intl2012_teamnames_23"	"Mortal Teamwork"
"announcer_announcer_intl2012_teamnames_24"	"TongFu"
"[english]announcer_announcer_intl2012_teamnames_24"	"TongFu"
"announcer_announcer_intl2012_teamnames_25"	"WE"
"[english]announcer_announcer_intl2012_teamnames_25"	"WE"
"announcer_announcer_intl2012_teamnames_26"	"World Elite"
"[english]announcer_announcer_intl2012_teamnames_26"	"World Elite"
"announcer_announcer_intl2012_teamnames_27"	"Mouz"
"[english]announcer_announcer_intl2012_teamnames_27"	"Mouz"
"announcer_announcer_intl2012_teamnames_28"	"Mousesports"
"[english]announcer_announcer_intl2012_teamnames_28"	"Mousesports"
"announcer_announcer_intl2013_teamnames_01"	"Alliance"
"[english]announcer_announcer_intl2013_teamnames_01"	"Alliance"
"announcer_announcer_intl2013_teamnames_02"	"Fnatic"
"[english]announcer_announcer_intl2013_teamnames_02"	"Fnatic"
"announcer_announcer_intl2013_teamnames_03"	"Team Liquid"
"[english]announcer_announcer_intl2013_teamnames_03"	"Team Liquid"
"announcer_announcer_intl2013_teamnames_04"	"Team Dignitas"
"[english]announcer_announcer_intl2013_teamnames_04"	"Team Dignitas"
"announcer_announcer_intl2013_teamnames_05"	"Virtus.Pro"
"[english]announcer_announcer_intl2013_teamnames_05"	"Virtus.Pro"
"announcer_announcer_intl2013_teamnames_06"	"Invasion MUFC"
"[english]announcer_announcer_intl2013_teamnames_06"	"Invasion MUFC"
"announcer_announcer_intl2013_teamnames_07"	"LGD"
"[english]announcer_announcer_intl2013_teamnames_07"	"LGD"
"announcer_announcer_intl2013_teamnames_08"	"LGD International"
"[english]announcer_announcer_intl2013_teamnames_08"	"LGD International"
"announcer_announcer_intl2013_teamnames_09"	"LGD cn"
"[english]announcer_announcer_intl2013_teamnames_09"	"LGD cn"
"announcer_announcer_intl2013_teamnames_10"	"LGD Imposters"
"[english]announcer_announcer_intl2013_teamnames_10"	"LGD Imposters"
"announcer_announcer_intl2013_teamnames_11"	"Quantic Gaming"
"[english]announcer_announcer_intl2013_teamnames_11"	"Quantic Gaming"
"announcer_announcer_intl2013_teamnames_12"	"RattleSnake"
"[english]announcer_announcer_intl2013_teamnames_12"	"RattleSnake"
"announcer_announcer_intl2012_teamnamevictory_01"	"Absolute Legends heeft gewonnen!"
"[english]announcer_announcer_intl2012_teamnamevictory_01"	"Absolute Legends victory!"
"announcer_announcer_intl2012_teamnamevictory_02"	"Na'Vi heeft gewonnen!"
"[english]announcer_announcer_intl2012_teamnamevictory_02"	"Na'Vi victory!"
"announcer_announcer_intl2012_teamnamevictory_03"	"DK heeft gewonnen!"
"[english]announcer_announcer_intl2012_teamnamevictory_03"	"DK victory!"
"announcer_announcer_intl2012_teamnamevictory_04"	"Orange heeft gewonnen!"
"[english]announcer_announcer_intl2012_teamnamevictory_04"	"Orange victory!"
"announcer_announcer_intl2012_teamnamevictory_05"	"EHOME heeft gewonnen!"
"[english]announcer_announcer_intl2012_teamnamevictory_05"	"EHOME victory!"
"announcer_announcer_intl2012_teamnamevictory_06"	"iG heeft gewonnen!"
"[english]announcer_announcer_intl2012_teamnamevictory_06"	"iG victory!"
"announcer_announcer_intl2012_teamnamevictory_07"	"compLexity heeft gewonnen!"
"[english]announcer_announcer_intl2012_teamnamevictory_07"	"compLexity victory!"
"announcer_announcer_intl2012_teamnamevictory_08"	"CLG heeft gewonnen!"
"[english]announcer_announcer_intl2012_teamnamevictory_08"	"CLG victory!"
"announcer_announcer_intl2012_teamnamevictory_09"	"EG heeft gewonnen!"
"[english]announcer_announcer_intl2012_teamnamevictory_09"	"EG victory!"
"announcer_announcer_intl2012_teamnamevictory_10"	"Zenith heeft gewonnen!"
"[english]announcer_announcer_intl2012_teamnamevictory_10"	"Zenith victory!"
"announcer_announcer_intl2012_teamnamevictory_11"	"Darer heeft gewonnen!"
"[english]announcer_announcer_intl2012_teamnamevictory_11"	"Darer victory!"
"announcer_announcer_intl2012_teamnamevictory_12"	"LGD heeft gewonnen!"
"[english]announcer_announcer_intl2012_teamnamevictory_12"	"LGD victory!"
"announcer_announcer_intl2012_teamnamevictory_13"	"MUFC heeft gewonnen!"
"[english]announcer_announcer_intl2012_teamnamevictory_13"	"MUFC victory!"
"announcer_announcer_intl2012_teamnamevictory_14"	"Moscow Five heeft gewonnen!"
"[english]announcer_announcer_intl2012_teamnamevictory_14"	"Moscow Five victory!"
"announcer_announcer_intl2012_teamnamevictory_15"	"mTw heeft gewonnen!"
"[english]announcer_announcer_intl2012_teamnamevictory_15"	"mTw victory!"
"announcer_announcer_intl2012_teamnamevictory_16"	"TongFu heeft gewonnen!"
"[english]announcer_announcer_intl2012_teamnamevictory_16"	"TongFu victory!"
"announcer_announcer_intl2012_teamnamevictory_17"	"World Elite heeft gewonnen!"
"[english]announcer_announcer_intl2012_teamnamevictory_17"	"World Elite victory!"
"announcer_announcer_intl2012_teamnamevictory_18"	"Mousesports heeft gewonnen!"
"[english]announcer_announcer_intl2012_teamnamevictory_18"	"Mousesports victory!"
"announcer_announcer_intl2013_teamnamevictory_01"	"Alliance heeft gewonnen!"
"[english]announcer_announcer_intl2013_teamnamevictory_01"	"Alliance victory!"
"announcer_announcer_intl2013_teamnamevictory_02"	"Fnatic heeft gewonnen!"
"[english]announcer_announcer_intl2013_teamnamevictory_02"	"Fnatic victory!"
"announcer_announcer_intl2013_teamnamevictory_03"	"Team Liquid heeft gewonnen!"
"[english]announcer_announcer_intl2013_teamnamevictory_03"	"Team Liquid victory!"
"announcer_announcer_intl2013_teamnamevictory_04"	"Team Dignitas heeft gewonnen!"
"[english]announcer_announcer_intl2013_teamnamevictory_04"	"Team Dignitas victory!"
"announcer_announcer_intl2013_teamnamevictory_05"	"Virtus.Pro heeft gewonnen!"
"[english]announcer_announcer_intl2013_teamnamevictory_05"	"Virtus.Pro victory!"
"announcer_announcer_intl2013_teamnamevictory_06"	"LGD heeft gewonnen!"
"[english]announcer_announcer_intl2013_teamnamevictory_06"	"LGD victory!"
"announcer_announcer_intl2013_teamnamevictory_07"	"LGD International heeft gewonnen!"
"[english]announcer_announcer_intl2013_teamnamevictory_07"	"LGD International victory!"
"announcer_announcer_intl2013_teamnamevictory_08"	"LGD.cn heeft gewonnen!"
"[english]announcer_announcer_intl2013_teamnamevictory_08"	"LGD.cn victory!"
"announcer_announcer_intl2013_teamnamevictory_09"	"LGD Imposters heeft gewonnen!"
"[english]announcer_announcer_intl2013_teamnamevictory_09"	"LGD Imposters victory!"
"announcer_announcer_intl2013_teamnamevictory_10"	"Invasion MUFC heeft gewonnen!"
"[english]announcer_announcer_intl2013_teamnamevictory_10"	"Invasion MUFC victory!"
"announcer_announcer_intl2013_teamnamevictory_11"	"Quantic Gaming heeft gewonnen!"
"[english]announcer_announcer_intl2013_teamnamevictory_11"	"Quantic Gaming victory!"
"announcer_announcer_intl2013_teamnamevictory_12"	"Rattlesnake heeft gewonnen!"
"[english]announcer_announcer_intl2013_teamnamevictory_12"	"RattleSnake victory!"
"announcer_announcer_intl2012_tourneystage_01"	"Kwartfinale."
"[english]announcer_announcer_intl2012_tourneystage_01"	"Quarter-Finals."
"announcer_announcer_intl2012_tourneystage_02"	"Halve finale."
"[english]announcer_announcer_intl2012_tourneystage_02"	"Semi-Finals."
"announcer_announcer_intl2012_tourneystage_03"	"Grote finale."
"[english]announcer_announcer_intl2012_tourneystage_03"	"Grand Finals."
"announcer_announcer_intl2012_usher_01"	"Pauze."
"[english]announcer_announcer_intl2012_usher_01"	"Intermission."
"announcer_announcer_intl2012_usher_02"	"Jullie aandacht graag."
"[english]announcer_announcer_intl2012_usher_02"	"Your attention please."
"announcer_announcer_intl2012_usher_03"	"De volgende wedstrijd staat op het punt te beginnen."
"[english]announcer_announcer_intl2012_usher_03"	"The next game is about to begin."
"announcer_announcer_intl2012_versus_01"	"tegen"
"[english]announcer_announcer_intl2012_versus_01"	"versus"
"announcer_announcer_intl2012_welcome_01"	"Welkom bij de Dota 2 International!"
"[english]announcer_announcer_intl2012_welcome_01"	"Welcome to the Dota 2 International!"
"announcer_announcer_welcome_02"	"Begin jouw training."
"[english]announcer_announcer_welcome_02"	"Begin your training."
"announcer_announcer_welcome_03"	"Jouw training begint nu."
"[english]announcer_announcer_welcome_03"	"Your training begins now."
"announcer_announcer_welcome_04"	"Welkom terug."
"[english]announcer_announcer_welcome_04"	"Welcome back."
"announcer_announcer_welcome_05"	"Welkom, veteraan."
"[english]announcer_announcer_welcome_05"	"Welcome, veteran."
"announcer_announcer_type_onevsone_01"	"Eén tegen één."
"[english]announcer_announcer_type_onevsone_01"	"One Versus One."
"announcer_ti4_ann_team_ban_01"	"Alliance mag verbannen."
"[english]announcer_ti4_ann_team_ban_01"	"Alliance's turn to ban."
"announcer_ti4_ann_team_ban_02"	"Titan mag verbannen."
"[english]announcer_ti4_ann_team_ban_02"	"Titan's turn to ban."
"announcer_ti4_ann_team_ban_04"	"Evil Geniuses mag verbannen."
"[english]announcer_ti4_ann_team_ban_04"	"Evil Geniuses' turn to ban."
"announcer_ti4_ann_team_ban_06"	"Fnatic mag verbannen."
"[english]announcer_ti4_ann_team_ban_06"	"Fnatic's turn to ban."
"announcer_ti4_ann_team_ban_07"	"NewBee mag verbannen."
"[english]announcer_ti4_ann_team_ban_07"	"NewBee's turn to ban."
"announcer_ti4_ann_team_ban_08"	"Vici Gaming mag verbannen."
"[english]announcer_ti4_ann_team_ban_08"	"Vici Gaming's turn to ban."
"announcer_ti4_ann_team_ban_10"	"Na'Vi mag verbannen."
"[english]announcer_ti4_ann_team_ban_10"	"Na'Vi's turn to ban."
"announcer_ti4_ann_team_ban_13"	"Team DK mag verbannen."
"[english]announcer_ti4_ann_team_ban_13"	"Team DK's turn to ban."
"announcer_ti4_ann_team_ban_14"	"Invictus Gaming mag verbannen."
"[english]announcer_ti4_ann_team_ban_14"	"Invictus Gaming's turn to ban."
"announcer_ti4_ann_team_ban_16"	"Cloud9 mag verbannen."
"[english]announcer_ti4_ann_team_ban_16"	"Cloud9's turn to ban."
"announcer_ti4_ann_team_ban_19"	"Team Empire mag verbannen."
"[english]announcer_ti4_ann_team_ban_19"	"Team Empire's turn to ban."
"announcer_ti4_ann_team_ban_20"	"Na'Vi.US mag verbannen."
"[english]announcer_ti4_ann_team_ban_20"	"Na'Vi.US's turn to ban."
"announcer_ti4_ann_team_ban_24"	"Arrow Gaming mag verbannen."
"[english]announcer_ti4_ann_team_ban_24"	"Arrow Gaming's turn to ban."
"announcer_ti4_ann_team_ban_25"	"Team Liquid mag verbannen."
"[english]announcer_ti4_ann_team_ban_25"	"Team Liquid's turn to ban."
"announcer_ti4_ann_team_ban_27"	"MVP Phoenix mag verbannen."
"[english]announcer_ti4_ann_team_ban_27"	"MVP Phoenix's turn to ban."
"announcer_ti4_ann_team_ban_30"	"LGD Gaming mag verbannen."
"[english]announcer_ti4_ann_team_ban_30"	"LGD Gaming's turn to ban."
"announcer_ti4_ann_team_ban_32"	"CIS Game mag verbannen."
"[english]announcer_ti4_ann_team_ban_32"	"CIS Game's turn to ban."
"announcer_ti4_ann_team_ban_34"	"Mousesports mag verbannen."
"[english]announcer_ti4_ann_team_ban_34"	"Mousesports' turn to ban."
"announcer_ti4_ann_team_ban_36"	"Virtus.pro mag verbannen."
"[english]announcer_ti4_ann_team_ban_36"	"Virtus.pro's turn to ban."
"announcer_ti4_ann_team_pick_01"	"Alliance mag kiezen."
"[english]announcer_ti4_ann_team_pick_01"	"Alliances turn to pick."
"announcer_ti4_ann_team_pick_02"	"Titan mag kiezen."
"[english]announcer_ti4_ann_team_pick_02"	"Titan's turn to pick."
"announcer_ti4_ann_team_pick_04"	"Evil Geniuses mag kiezen."
"[english]announcer_ti4_ann_team_pick_04"	"Evil Geniuses's turn to pick."
"announcer_ti4_ann_team_pick_06"	"Fnatic mag kiezen."
"[english]announcer_ti4_ann_team_pick_06"	"Fnatic's turn to pick."
"announcer_ti4_ann_team_pick_07"	"NewBee mag kiezen."
"[english]announcer_ti4_ann_team_pick_07"	"NewBee's turn to pick."
"announcer_ti4_ann_team_pick_08"	"Vici Gaming mag kiezen."
"[english]announcer_ti4_ann_team_pick_08"	"Vici Gaming's turn to pick."
"announcer_ti4_ann_team_pick_10"	"Na'Vi mag kiezen."
"[english]announcer_ti4_ann_team_pick_10"	"Na'Vi's turn to pick."
"announcer_ti4_ann_team_pick_13"	"Team DK mag kiezen."
"[english]announcer_ti4_ann_team_pick_13"	"Team DK's turn to pick."
"announcer_ti4_ann_team_pick_14"	"Invictus Gaming mag kiezen."
"[english]announcer_ti4_ann_team_pick_14"	"Invictus Gaming's turn to pick."
"announcer_ti4_ann_team_pick_16"	"Cloud9 mag kiezen."
"[english]announcer_ti4_ann_team_pick_16"	"Cloud9's turn to pick."
"announcer_ti4_ann_team_pick_18"	"Team Empire mag kiezen."
"[english]announcer_ti4_ann_team_pick_18"	"Team Empire's turn to pick."
"announcer_ti4_ann_team_pick_19"	"Na'Vi.US mag kiezen."
"[english]announcer_ti4_ann_team_pick_19"	"Na'Vi.US's turn to pick."
"announcer_ti4_ann_team_pick_23"	"Arrow Gaming mag kiezen."
"[english]announcer_ti4_ann_team_pick_23"	"Arrow Gaming's turn to pick."
"announcer_ti4_ann_team_pick_24"	"Team Liquid mag kiezen."
"[english]announcer_ti4_ann_team_pick_24"	"Team Liquid's turn to pick."
"announcer_ti4_ann_team_pick_26"	"MVP Phoenix mag kiezen."
"[english]announcer_ti4_ann_team_pick_26"	"MVP Phoenix's turn to pick."
"announcer_ti4_ann_team_pick_29"	"LGD Gaming mag kiezen."
"[english]announcer_ti4_ann_team_pick_29"	"LGD Gaming's turn to pick."
"announcer_ti4_ann_team_pick_31"	"CIS Game mag kiezen."
"[english]announcer_ti4_ann_team_pick_31"	"CIS Game's turn to pick."
"announcer_ti4_ann_team_pick_33"	"Mousesports mag kiezen."
"[english]announcer_ti4_ann_team_pick_33"	"Mousesports's turn to pick."
"announcer_ti4_ann_team_pick_35"	"Virtus.pro mag kiezen."
"[english]announcer_ti4_ann_team_pick_35"	"Virtus.pro's turn to pick."
"announcer_ti4_ann_team_names_01"	"Alliance"
"[english]announcer_ti4_ann_team_names_01"	"Alliance"
"announcer_ti4_ann_team_names_02"	"Titan"
"[english]announcer_ti4_ann_team_names_02"	"Titan"
"announcer_ti4_ann_team_names_04"	"Evil Geniuses"
"[english]announcer_ti4_ann_team_names_04"	"Evil Geniuses"
"announcer_ti4_ann_team_names_06"	"Fnatic"
"[english]announcer_ti4_ann_team_names_06"	"Fnatic"
"announcer_ti4_ann_team_names_07"	"NewBee"
"[english]announcer_ti4_ann_team_names_07"	"NewBee"
"announcer_ti4_ann_team_names_08"	"Vici Gaming"
"[english]announcer_ti4_ann_team_names_08"	"Vici Gaming"
"announcer_ti4_ann_team_names_10"	"Na'Vi"
"[english]announcer_ti4_ann_team_names_10"	"Na'Vi"
"announcer_ti4_ann_team_names_13"	"Team DK"
"[english]announcer_ti4_ann_team_names_13"	"Team DK"
"announcer_ti4_ann_team_names_14"	"Invictus Gaming"
"[english]announcer_ti4_ann_team_names_14"	"Invictus Gaming"
"announcer_ti4_ann_team_names_16"	"Cloud9"
"[english]announcer_ti4_ann_team_names_16"	"Cloud9"
"announcer_ti4_ann_team_names_18"	"Team Empire"
"[english]announcer_ti4_ann_team_names_18"	"Team Empire"
"announcer_ti4_ann_team_names_19"	"Na'Vi.US"
"[english]announcer_ti4_ann_team_names_19"	"Na'Vi.US"
"announcer_ti4_ann_team_names_23"	"Arrow Gaming"
"[english]announcer_ti4_ann_team_names_23"	"Arrow Gaming"
"announcer_ti4_ann_team_names_24"	"Team Liquid"
"[english]announcer_ti4_ann_team_names_24"	"Team Liquid"
"announcer_ti4_ann_team_names_26"	"MVP Phoenix"
"[english]announcer_ti4_ann_team_names_26"	"MVP Phoenix"
"announcer_ti4_ann_team_names_29"	"LGD Gaming"
"[english]announcer_ti4_ann_team_names_29"	"LGD Gaming"
"announcer_ti4_ann_team_names_31"	"CIS Game"
"[english]announcer_ti4_ann_team_names_31"	"CIS Game"
"announcer_ti4_ann_team_names_34"	"Mousesports"
"[english]announcer_ti4_ann_team_names_34"	"Mousesports"
"announcer_ti4_ann_team_names_36"	"Virtus.pro"
"[english]announcer_ti4_ann_team_names_36"	"Virtus.pro"
"announcer_ti4_ann_team_victory_01"	"Alliance wint!"
"[english]announcer_ti4_ann_team_victory_01"	"Alliance victory!"
"announcer_ti4_ann_team_victory_02"	"Titan wint!"
"[english]announcer_ti4_ann_team_victory_02"	"Titan victory!"
"announcer_ti4_ann_team_victory_04"	"Evil Geniuses wint!"
"[english]announcer_ti4_ann_team_victory_04"	"Evil Geniuses victory!"
"announcer_ti4_ann_team_victory_06"	"Fnatic wint!"
"[english]announcer_ti4_ann_team_victory_06"	"Fnatic victory!"
"announcer_ti4_ann_team_victory_07"	"NewBee wint!"
"[english]announcer_ti4_ann_team_victory_07"	"NewBee victory!"
"announcer_ti4_ann_team_victory_08"	"Vici Gaming wint!"
"[english]announcer_ti4_ann_team_victory_08"	"Vici Gaming victory!"
"announcer_ti4_ann_team_victory_10"	"Na'Vi wint!"
"[english]announcer_ti4_ann_team_victory_10"	"Na'Vi victory!"
"announcer_ti4_ann_team_victory_13"	"Team DK wint!"
"[english]announcer_ti4_ann_team_victory_13"	"Team DK victory!"
"announcer_ti4_ann_team_victory_14"	"Invictus Gaming wint!"
"[english]announcer_ti4_ann_team_victory_14"	"Invictus Gaming victory!"
"announcer_ti4_ann_team_victory_16"	"Cloud9 wint!"
"[english]announcer_ti4_ann_team_victory_16"	"Cloud9 victory!"
"announcer_ti4_ann_team_victory_18"	"Team Empire wint!"
"[english]announcer_ti4_ann_team_victory_18"	"Team Empire victory!"
"announcer_ti4_ann_team_victory_19"	"Na'Vi.US wint!"
"[english]announcer_ti4_ann_team_victory_19"	"Na'Vi.US victory!"
"announcer_ti4_ann_team_victory_23"	"Arrow Gaming wint!"
"[english]announcer_ti4_ann_team_victory_23"	"Arrow Gaming victory!"
"announcer_ti4_ann_team_victory_24"	"Team Liquid wint!"
"[english]announcer_ti4_ann_team_victory_24"	"Team Liquid victory!"
"announcer_ti4_ann_team_victory_26"	"MVP Phoenix wint!"
"[english]announcer_ti4_ann_team_victory_26"	"MVP Phoenix victory!"
"announcer_ti4_ann_team_victory_30"	"LGD Gaming wint!"
"[english]announcer_ti4_ann_team_victory_30"	"LGD Gaming victory!"
"announcer_ti4_ann_team_victory_32"	"CIS Game wint!"
"[english]announcer_ti4_ann_team_victory_32"	"CIS Game victory!"
"announcer_ti4_ann_team_victory_34"	"Mousesports wint!"
"[english]announcer_ti4_ann_team_victory_34"	"Mousesports victory!"
"announcer_ti4_ann_team_victory_36"	"Virtus.pro wint!"
"[english]announcer_ti4_ann_team_victory_36"	"Virtus.pro victory!"
}
}
