"lang"
{
"Language"	"czech"
"Tokens"
{
"Tutorial.NPXDEM_1"	"Ve hře Dota se na rozlehlém bojišti střetávají dva týmy.\nKaždý tým, ať už tým Radiant nebo Dire, se skládá z 5 hráčů.\nTen z týmů, který jako první zničí nepřátelského Ancienta, zvítězí."
"[english]Tutorial.NPXDEM_1"	"In Dota, two teams face each other across a vast battlefield.\nThe teams, called Radiant and Dire, are each made up of 5 players.\nWhichever team is able to destroy the opposing team's Ancient will claim victory."
"Tutorial.NPXDEM_2"	"Na bojišti se kromě základen nachází spousta důležitých míst.\nOd monster zamořených džunglí po řeku, jež rozděluje mapu na dvě části."
"[english]Tutorial.NPXDEM_2"	"Across the battlefield are scattered a number of important locations.\nFrom monster infested jungles to the river, which divides the team's starting territories."
"Tutorial.NPXDEM_3"	"Na začátku zápasu si každý hráč vybere jednoho z hrdinů\na utratí svoje počáteční zlaťáky za několik levnějších předmětů."
"[english]Tutorial.NPXDEM_3"	"As the match begins, each player chooses a Hero from a diverse roster,\nand then spends their starting gold on a handful of inexpensive items."
"Tutorial.NPXDEM_4"	"V obou základnách se nachází tři skupiny kasáren, z nichž do boje vybíhají neovladatelné jednotky zvané „creepové“.\nTito creepové postupují po jedné ze tří linek vstříc nepřátelské základně."
"[english]Tutorial.NPXDEM_4"	"Within each Base are three sets of Barracks, where uncontrollable units called Creeps march forth.\nThese Creeps progress down one of the three lanes toward the enemy Base."
"Tutorial.NPXDEM_5"	"Každá linka je chráněna obrannými věžemi, které útočí na blízké nepřátelské creepy a hrdiny.\nV rané fázi bitvy musí hrdinové nejprve nabrat síly, a proto je pro ně vhodné postupovat\nse svými creepy, kteří jim poskytnou alespoň částečnou ochranu proti nepřátelům."
"[english]Tutorial.NPXDEM_5"	"Each lane is protected by three defensive Towers, which will attack advancing Creeps or Heroes.\nIn the early stages of battle, Heroes have yet to gather their strength, and may wish\nto travel with their Creeps for protection from enemy Creeps and other forces."
"Tutorial.NPXDEM_6"	"Jak bitva pokračuje, hrdinové zabíjejí nepřátelské creepy a hrdiny, za což získávají zlaťáky a zkušenosti.\nDíky tomu jsou poté schopni zaútočit na nepřátelské obranné věže."
"[english]Tutorial.NPXDEM_6"	"As the battle continues, Heroes kill enemy Creeps and enemy Heroes to gain gold and experience.\nThis will allow them to gain power and begin assaulting the enemy Team's outer defensive Towers."
"Tutorial.NPXDEM_8"	"Řeka je zdrojem run. Ty poskytují dočasné, avšak silné bonusy."
"[english]Tutorial.NPXDEM_8"	"The river is the source of Runes. Runes provide temporary, but powerful bonuses."
"Tutorial.NPXDEM_9"	"Pro hrdiny je občas lepší bojovat s neutrálními creepy v džunglích\nnebo shromáždit své druhy a vytáhnout na mocného Roshana, jehož skolením lze získat\noživující předmět Aegis of Immortality."
"[english]Tutorial.NPXDEM_9"	"Heroes might sometimes find it safer to attack Neutral Creeps in the jungles,\nor they may gather to assault the mighty Roshan in his lair, hoping to harvest\nhis resurrecting Aegis of Immortality."
"Tutorial.NPXDEM_10"	"Po určité době se tým stane natolik silným, že se bude moci pokusit zaútočit na nepřátelskou základnu.\nPokud v ní zničí nepřátelské kasárny, získá v dané lince silné a velké mega creepy."
"[english]Tutorial.NPXDEM_10"	"In time, a Team will become powerful enough to advance their forces into the enemy Base,\nwhere they may destroy the enemy Barracks to grant themselves Mega-Creeps in that lane."
"Tutorial.NPXDEM_11"	"Poté, co tým prorazí vnitřní obranu, musí zničit Ancienta. Tak zvítězí."
"[english]Tutorial.NPXDEM_11"	"Once they have breached the enemy's inner defenses,\nthe Team must attack and destroy the Ancient to claim victory."
}
}
