"lang"
{
"Language"	"dutch"
"Tokens"
{
"Tutorial.NPXDEM_1"	"In Dota strijden twee teams tegen elkaar op een groot gevechtsveld.\nDe teams, die Radiant en Dire heten, bestaan elk uit 5 spelers.\nHet team dat de Ancient van het andere team weet te vernietigen wint."
"[english]Tutorial.NPXDEM_1"	"In Dota, two teams face each other across a vast battlefield.\nThe teams, called Radiant and Dire, are each made up of 5 players.\nWhichever team is able to destroy the opposing team's Ancient will claim victory."
"Tutorial.NPXDEM_2"	"Over het slagveld zijn een paar belangrijke locaties verspreid.\nVan door monsters vergeven jungles tot de rivier, die de begingebieden van de teams opsplitst."
"[english]Tutorial.NPXDEM_2"	"Across the battlefield are scattered a number of important locations.\nFrom monster infested jungles to the river, which divides the team's starting territories."
"Tutorial.NPXDEM_3"	"Wanneer de wedstrijd begint kiest elke speler een held uit een divers rooster,\nen geeft hij of zij het begingoud uit aan een handjevol goedkope items."
"[english]Tutorial.NPXDEM_3"	"As the match begins, each player chooses a Hero from a diverse roster,\nand then spends their starting gold on a handful of inexpensive items."
"Tutorial.NPXDEM_4"	"In elke basis zijn drie sets barakken, waar niet te besturen eenheden genaamd Creeps vanuit voort marcheren.\nDeze Creeps volgen een van de drie paden richting de vijandelijke basis."
"[english]Tutorial.NPXDEM_4"	"Within each Base are three sets of Barracks, where uncontrollable units called Creeps march forth.\nThese Creeps progress down one of the three lanes toward the enemy Base."
"Tutorial.NPXDEM_5"	"Elk pad wordt beschermd door drie verdedigende torens, die aankomende Creeps of helden zullen aanvallen.\nIn de vroege stages van de strijd hebben helden nog niet hun kracht weten te verzamelen, en is het misschien handig\nvoor ze om met hun Creeps mee te lopen voor bescherming tegen vijandelijke Creeps en andere krachten."
"[english]Tutorial.NPXDEM_5"	"Each lane is protected by three defensive Towers, which will attack advancing Creeps or Heroes.\nIn the early stages of battle, Heroes have yet to gather their strength, and may wish\nto travel with their Creeps for protection from enemy Creeps and other forces."
"Tutorial.NPXDEM_6"	"Naarmate de strijd vordert doden helden vijandelijke Creeps en vijandelijke helden om goud en ervaring te verdienen.\nDit staat ze toe om kracht te verkrijgen en te beginnen met het aanvallen van de buitenste verdedigende torens van het vijandelijke team."
"[english]Tutorial.NPXDEM_6"	"As the battle continues, Heroes kill enemy Creeps and enemy Heroes to gain gold and experience.\nThis will allow them to gain power and begin assaulting the enemy Team's outer defensive Towers."
"Tutorial.NPXDEM_8"	"De rivier is de bron van runen. Runen voorzien spelers van tijdelijke, maar krachtige bonussen."
"[english]Tutorial.NPXDEM_8"	"The river is the source of Runes. Runes provide temporary, but powerful bonuses."
"Tutorial.NPXDEM_9"	"Helden vinden het soms misschien veiliger om neutrale Creeps in de jungles aan te vallen,\nof ze kunnen samenkomen om de machtige Roshan in zijn schuilplaats aan te vallen, hopend op het verkrijgen\nvan zijn opnieuw tot leven brengende Aegis of Immortality."
"[english]Tutorial.NPXDEM_9"	"Heroes might sometimes find it safer to attack Neutral Creeps in the jungles,\nor they may gather to assault the mighty Roshan in his lair, hoping to harvest\nhis resurrecting Aegis of Immortality."
"Tutorial.NPXDEM_10"	"Na verloop van tijd zal een team sterk genoeg worden om met hun eenheden de vijandelijke basis te bereiken,\nwaar ze de vijandelijke barakken kunnen vernietigen om zelf op dat pad Mega-Creeps te krijgen."
"[english]Tutorial.NPXDEM_10"	"In time, a Team will become powerful enough to advance their forces into the enemy Base,\nwhere they may destroy the enemy Barracks to grant themselves Mega-Creeps in that lane."
"Tutorial.NPXDEM_11"	"Wanneer ze de binnenste verdedigingen van de vijand doorbroken hebben,\nmoet het team de Ancient aanvallen en vernietigen om te zegevieren."
"[english]Tutorial.NPXDEM_11"	"Once they have breached the enemy's inner defenses,\nthe Team must attack and destroy the Ancient to claim victory."
}
}
