"lang"
{
"Language"	"thai"
"Tokens"
{
"Tutorial.NPXDEM_1"	"ใน Dota จะแบ่งเป็นสองทีมเผขิญหน้ากันกลางสมรภูมิที่ใหญ่โต \nทีมมีชื่อเรียกว่า Radiant และ Dire โดยแต่ละทีมจะประกอบด้วยผู้เล่นละ 5 คน\n ทีมใดก็ตามที่สามารถทำลาย Ancient ของทีมฝ่ายตรงข้ามได้จะเป็นผู้่ชนะ"
"[english]Tutorial.NPXDEM_1"	"In Dota, two teams face each other across a vast battlefield.\nThe teams, called Radiant and Dire, are each made up of 5 players.\nWhichever team is able to destroy the opposing team's Ancient will claim victory."
"Tutorial.NPXDEM_2"	"ทั่วพรมแดนสนามรบเต็มไปด้วยสถานที่ที่สำคัญกระจัดกระจายอยู่ทั่ว \nตั้งแต่ป่าที่เต็มไปด้วยสัตว์ประหลาดยุ่มย่ามอยู่ ไปจนถึงแม่น้ำที่ตัดแบ่งเขตแดนเริ่มต้นของทีม"
"[english]Tutorial.NPXDEM_2"	"Across the battlefield are scattered a number of important locations.\nFrom monster infested jungles to the river, which divides the team's starting territories."
"Tutorial.NPXDEM_3"	"เมื่อการแข่งขันเริ่มขึ้น ผู้เล่นแต่ละคนจะเลือก Hero จากบัญชีรายชื่อมากมาย \nและเริ่มใช้เงินทองในตอนเริ่มต้นซื้อไอเทมที่ราคาย่อมเยาจำนวนพอประมาณ"
"[english]Tutorial.NPXDEM_3"	"As the match begins, each player chooses a Hero from a diverse roster,\nand then spends their starting gold on a handful of inexpensive items."
"Tutorial.NPXDEM_4"	"ภายในฐานทัพของแต่ละทีมประกอบด้วยค่ายทหารสามค่าย ที่ๆซึ่งกลุ่มทัพที่เราไม่สามารถควบคุมได้ที่เรียกกันว่า Creep เดินทัพ \n ซึ่ง Creep เหล่านี้เคลื่อนทัพบุกไปตามทั้งสามเลนเพื่อมุ่งไปยังฐานทัพของศัตรู"
"[english]Tutorial.NPXDEM_4"	"Within each Base are three sets of Barracks, where uncontrollable units called Creeps march forth.\nThese Creeps progress down one of the three lanes toward the enemy Base."
"Tutorial.NPXDEM_5"	"แต่ละเลนถูกปกป้องโดยป้อมปราการ (Tower) สามป้อม ที่จะโจมตี Creep หรือ ฮีโร่ ที่เข้ามาในเขต \nในช่วงแรกของการรบ เหล่าฮีโร่อาจต้องอยู่ร่วมกันไว้และอาจต้อง \nเดินทางร่วมกับ Creep ของพวกเขาเพื่อให้คอยคุ้มครองกันจาก Creep ฝ่ายศัตรูหรือศัตรูอื่นๆ"
"[english]Tutorial.NPXDEM_5"	"Each lane is protected by three defensive Towers, which will attack advancing Creeps or Heroes.\nIn the early stages of battle, Heroes have yet to gather their strength, and may wish\nto travel with their Creeps for protection from enemy Creeps and other forces."
"Tutorial.NPXDEM_6"	"เมื่อการสู้รบยังคงดำเนินต่อเนื่อง ฮีโร่ที่สังหาร Creep ฝ่ายศัตรูหรือฮีโร่ศัตรู จะได้รับเงินทองและค่าประสบการณ์ \nซึ่งจะส่งผลให้พวกเขาได้รับพละกำลังมากขึ้น และเริ่มบุกโจมตีป้อมปราการเขตนอกของทีมฝั่งศัตรูได้"
"[english]Tutorial.NPXDEM_6"	"As the battle continues, Heroes kill enemy Creeps and enemy Heroes to gain gold and experience.\nThis will allow them to gain power and begin assaulting the enemy Team's outer defensive Towers."
"Tutorial.NPXDEM_8"	"แม่น้ำคือแหล่งของ Rune ซึ่ง Rune เหล่านี้จะคงอยู่ชั่วคราว แต่มอบโบนัสความสามารถที่ทรงพลัง"
"[english]Tutorial.NPXDEM_8"	"The river is the source of Runes. Runes provide temporary, but powerful bonuses."
"Tutorial.NPXDEM_9"	"บางครั้งเหล่าฮีโร่อาจหาที่ที่ปลอดภัยกว่าด้วยการไปโจมตี Neutral Creep ในป่า \nหรือพวกเขาอาจรวมตัวกันเพื่อบุกโจมตี Roshan ที่ทรงพลังในรังของมัน มุ่งหวังที่จะชิง \nAegis of Immortality โล่แห่งความอมตะของมัน"
"[english]Tutorial.NPXDEM_9"	"Heroes might sometimes find it safer to attack Neutral Creeps in the jungles,\nor they may gather to assault the mighty Roshan in his lair, hoping to harvest\nhis resurrecting Aegis of Immortality."
"Tutorial.NPXDEM_10"	"ไม่ช้าก็เร็ว ทีมจะแข็งแกร่งพอที่จะบุกโจมตีไปถึงฐานของศัตรู \nที่ซึ่งพวกเขาอาจสามารถทำลายค่าย Barrack เพื่อเสริมกำลังทัพพวกเขาเป็น Mega-Creep ในเลนนั้นๆ"
"[english]Tutorial.NPXDEM_10"	"In time, a Team will become powerful enough to advance their forces into the enemy Base,\nwhere they may destroy the enemy Barracks to grant themselves Mega-Creeps in that lane."
"Tutorial.NPXDEM_11"	"เมื่อพวกเขาสามารถทำลายแนวป้องกันของศัตรูได้แล้ว \nผู้เล่นทีมจะต้องโจมตีและทำลาย Ancient เพื่อประกาศชัยชนะ"
"[english]Tutorial.NPXDEM_11"	"Once they have breached the enemy's inner defenses,\nthe Team must attack and destroy the Ancient to claim victory."
}
}
