"lang"
{
"Language"	"czech"
"Tokens"
{
"announcer_announcer_welcome_01"	"Vítej ve hře Dota!"
"[english]announcer_announcer_welcome_01"	"Welcome to Dota!"
"announcer_announcer_pick_yr"	"Nyní vybírá tvůj tým."
"[english]announcer_announcer_pick_yr"	"Your turn to pick."
"announcer_announcer_pick_enm"	"Nyní vybírá tým nepřítele."
"[english]announcer_announcer_pick_enm"	"Enemy's turn to pick."
"announcer_announcer_pick_rad"	"Nyní vybírá tým Radiant."
"[english]announcer_announcer_pick_rad"	"Radiant team pick."
"announcer_announcer_pick_dire"	"Nyní vybírá tým Dire."
"[english]announcer_announcer_pick_dire"	"Dire team pick."
"announcer_announcer_ban_yr"	"Nyní volí ban tvůj tým."
"[english]announcer_announcer_ban_yr"	"Your turn to ban."
"announcer_announcer_ban_enm"	"Nyní volí ban tým nepřítele."
"[english]announcer_announcer_ban_enm"	"Enemy's turn to ban."
"announcer_announcer_ban_dire"	"Nyní volí ban tým Dire."
"[english]announcer_announcer_ban_dire"	"Dire team ban."
"announcer_announcer_ban_rad"	"Nyní volí ban tým Radiant."
"[english]announcer_announcer_ban_rad"	"Radiant team ban."
"announcer_announcer_team_complete_dire"	"Tým Dire je kompletní."
"[english]announcer_announcer_team_complete_dire"	"Dire's team is complete."
"announcer_announcer_team_complete_rad"	"Tým Radiant je kompletní."
"[english]announcer_announcer_team_complete_rad"	"Radiant's team is complete."
"announcer_announcer_team_complete_yr"	"Tvůj tým je kompletní."
"[english]announcer_announcer_team_complete_yr"	"Your team is complete."
"announcer_announcer_team_complete_our"	"Náš tým je kompletní."
"[english]announcer_announcer_team_complete_our"	"Our team is complete."
"announcer_announcer_now_select"	"Nyní si můžeš vybrat hrdinu."
"[english]announcer_announcer_now_select"	"You may now select your heroes."
"announcer_announcer_choose_hero"	"Vyber si hrdinu."
"[english]announcer_announcer_choose_hero"	"Choose your hero."
"announcer_announcer_time_reserve"	"Rezervní čas."
"[english]announcer_announcer_time_reserve"	"Reserve time."
"announcer_announcer_count_pick_10"	"Zbývá deset sekund."
"[english]announcer_announcer_count_pick_10"	"Ten seconds remaining."
"announcer_announcer_count_pick_5"	"Zbývá pět sekund."
"[english]announcer_announcer_count_pick_5"	"Five seconds remaining."
"announcer_announcer_count_battle_30"	"Do bitvy zbývá třicet sekund."
"[english]announcer_announcer_count_battle_30"	"Thirty seconds to battle."
"announcer_announcer_count_battle_10"	"Do bitvy zbývá deset sekund."
"[english]announcer_announcer_count_battle_10"	"Ten seconds to battle."
"announcer_announcer_battle_prepare_01"	"Připrav se na bitvu."
"[english]announcer_announcer_battle_prepare_01"	"Prepare for battle."
"announcer_announcer_battle_begin_01"	"Bitva začíná!"
"[english]announcer_announcer_battle_begin_01"	"The battle begins!"
"announcer_announcer_anc_attack_yr"	"Tvůj Ancient je pod útokem."
"[english]announcer_announcer_anc_attack_yr"	"Your ancient is under attack."
"announcer_announcer_anc_attack_rad"	"Ancient týmu Radiant je pod útokem."
"[english]announcer_announcer_anc_attack_rad"	"Radiant's ancient is under attack."
"announcer_announcer_anc_attack_dire"	"Ancient týmu Dire je pod útokem."
"[english]announcer_announcer_anc_attack_dire"	"Dire's ancient is under attack."
"announcer_announcer_twr_attack_rad_top"	"Vrchní věž týmu Radiant je pod útokem."
"[english]announcer_announcer_twr_attack_rad_top"	"Radiant's top tower is under attack."
"announcer_announcer_twr_attack_rad_mid"	"Prostřední věž týmu Radiant je pod útokem."
"[english]announcer_announcer_twr_attack_rad_mid"	"Radiant's middle tower is under attack."
"announcer_announcer_twr_attack_rad_bot"	"Spodní věž týmu Radiant je pod útokem."
"[english]announcer_announcer_twr_attack_rad_bot"	"Radiant's bottom tower is under attack."
"announcer_announcer_twr_attack_dire_top"	"Vrchní věž týmu Dire je pod útokem."
"[english]announcer_announcer_twr_attack_dire_top"	"Dire's top tower is under attack."
"announcer_announcer_twr_attack_dire_mid"	"Prostřední věž týmu Dire je pod útokem."
"[english]announcer_announcer_twr_attack_dire_mid"	"Dire's middle tower is under attack."
"announcer_announcer_twr_attack_dire_bot"	"Spodní věž týmu Dire je pod útokem."
"[english]announcer_announcer_twr_attack_dire_bot"	"Dire's bottom tower is under attack."
"announcer_announcer_twr_attack_yr_top"	"Tvoje vrchní věž je pod útokem."
"[english]announcer_announcer_twr_attack_yr_top"	"Your top tower is under attack."
"announcer_announcer_twr_attack_yr_mid"	"Tvoje prostřední věž je pod útokem."
"[english]announcer_announcer_twr_attack_yr_mid"	"Your middle tower is under attack."
"announcer_announcer_twr_attack_yr_bot"	"Tvoje spodní věž je pod útokem."
"[english]announcer_announcer_twr_attack_yr_bot"	"Your bottom tower is under attack."
"announcer_announcer_twr_fall_yr_top"	"Tvoje vrchní věž byla zničena."
"[english]announcer_announcer_twr_fall_yr_top"	"Your top tower has fallen."
"announcer_announcer_twr_fall_yr_mid"	"Tvoje prostřední věž byla zničena."
"[english]announcer_announcer_twr_fall_yr_mid"	"Your middle tower has fallen."
"announcer_announcer_twr_fall_yr_bot"	"Tvoje spodní věž byla zničena."
"[english]announcer_announcer_twr_fall_yr_bot"	"Your bottom tower has fallen."
"announcer_announcer_twr_fall_rad_top"	"Vrchní věž týmu Radiant byla zničena."
"[english]announcer_announcer_twr_fall_rad_top"	"Radiant's top tower has fallen."
"announcer_announcer_twr_fall_rad_mid"	"Prostřední věž týmu Radiant byla zničena."
"[english]announcer_announcer_twr_fall_rad_mid"	"Radiant's middle tower has fallen."
"announcer_announcer_twr_fall_rad_bot"	"Spodní věž týmu Radiant byla zničena."
"[english]announcer_announcer_twr_fall_rad_bot"	"Radiant's bottom tower has fallen."
"announcer_announcer_twr_fall_dire_top"	"Vrchní věž týmu Dire byla zničena."
"[english]announcer_announcer_twr_fall_dire_top"	"Dire's top tower has fallen."
"announcer_announcer_twr_fall_dire_mid"	"Prostřední věž týmu Dire byla zničena."
"[english]announcer_announcer_twr_fall_dire_mid"	"Dire's middle tower has fallen."
"announcer_announcer_twr_fall_dire_bot"	"Spodní věž týmu Dire byla zničena."
"[english]announcer_announcer_twr_fall_dire_bot"	"Dire's bottom tower has fallen."
"announcer_announcer_twr_fall_enm_top"	"Vrchní věž nepřítele byla zničena."
"[english]announcer_announcer_twr_fall_enm_top"	"The enemy's top tower has fallen."
"announcer_announcer_twr_fall_enm_mid"	"Prostřední věž nepřítele byla zničena."
"[english]announcer_announcer_twr_fall_enm_mid"	"The enemy's middle tower has fallen."
"announcer_announcer_twr_fall_enm_bot"	"Spodní věž nepřítele byla zničena."
"[english]announcer_announcer_twr_fall_enm_bot"	"The enemy's bottom tower has fallen."
"announcer_announcer_rax_attack_yr_top"	"Tvoje vrchní kasárny jsou pod útokem."
"[english]announcer_announcer_rax_attack_yr_top"	"Your top barracks are under attack."
"announcer_announcer_rax_attack_yr_mid"	"Tvoje prostřední kasárny jsou pod útokem."
"[english]announcer_announcer_rax_attack_yr_mid"	"Your middle barracks are under attack."
"announcer_announcer_rax_attack_yr_bot"	"Tvoje spodní kasárny jsou pod útokem."
"[english]announcer_announcer_rax_attack_yr_bot"	"Your bottom barracks are under attack."
"announcer_announcer_rax_attack_rad_top"	"Vrchní kasárny týmu Radiant jsou pod útokem."
"[english]announcer_announcer_rax_attack_rad_top"	"Radiant's top barracks are under attack."
"announcer_announcer_rax_attack_rad_mid"	"Prostřední kasárny týmu Radiant jsou pod útokem."
"[english]announcer_announcer_rax_attack_rad_mid"	"Radiant's middle barracks are under attack."
"announcer_announcer_rax_attack_rad_bot"	"Spodní kasárny týmu Radiant jsou pod útokem."
"[english]announcer_announcer_rax_attack_rad_bot"	"Radiant's bottom barracks are under attack."
"announcer_announcer_rax_attack_dire_top"	"Vrchní kasárny týmu Dire jsou pod útokem."
"[english]announcer_announcer_rax_attack_dire_top"	"Dire's top barracks are under attack."
"announcer_announcer_rax_attack_dire_mid"	"Prostřední kasárny týmu Dire jsou pod útokem."
"[english]announcer_announcer_rax_attack_dire_mid"	"Dire's middle barracks are under attack."
"announcer_announcer_rax_attack_dire_bot"	"Spodní kasárny týmu Dire jsou pod útokem."
"[english]announcer_announcer_rax_attack_dire_bot"	"Dire's bottom barracks are under attack."
"announcer_announcer_rax_fall_yr_top"	"Tvoje vrchní kasárny byly zničeny."
"[english]announcer_announcer_rax_fall_yr_top"	"Your top barracks has fallen."
"announcer_announcer_rax_fall_yr_mid"	"Tvoje prostřední kasárny byly zničeny."
"[english]announcer_announcer_rax_fall_yr_mid"	"Your middle barracks has fallen."
"announcer_announcer_rax_fall_yr_bot"	"Tvoje spodní kasárny byly zničeny."
"[english]announcer_announcer_rax_fall_yr_bot"	"Your bottom barracks has fallen."
"announcer_announcer_rax_fall_rad_top"	"Vrchní kasárny týmu Radiant byly zničeny."
"[english]announcer_announcer_rax_fall_rad_top"	"Radiant's top barracks has fallen."
"announcer_announcer_rax_fall_rad_mid"	"Prostřední kasárny týmu Radiant byly zničeny."
"[english]announcer_announcer_rax_fall_rad_mid"	"Radiant's middle barracks has fallen."
"announcer_announcer_rax_fall_rad_bot"	"Spodní kasárny týmu Radiant byly zničeny."
"[english]announcer_announcer_rax_fall_rad_bot"	"Radiant's bottom barracks has fallen."
"announcer_announcer_rax_fall_dire_top"	"Vrchní kasárny týmu Dire byly zničeny."
"[english]announcer_announcer_rax_fall_dire_top"	"Dire's top barracks has fallen."
"announcer_announcer_rax_fall_dire_mid"	"Prostřední kasárny týmu Dire byly zničeny."
"[english]announcer_announcer_rax_fall_dire_mid"	"Dire's middle barracks has fallen."
"announcer_announcer_rax_fall_dire_bot"	"Spodní kasárny týmu Dire byly zničeny."
"[english]announcer_announcer_rax_fall_dire_bot"	"Dire's bottom barracks has fallen."
"announcer_announcer_rax_fall_enm_top"	"Vrchní kasárny nepřítele byly zničeny."
"[english]announcer_announcer_rax_fall_enm_top"	"The enemy's top barracks has fallen."
"announcer_announcer_rax_fall_enm_mid"	"Prostřední kasárny nepřítele byly zničeny."
"[english]announcer_announcer_rax_fall_enm_mid"	"The enemy's middle barracks has fallen."
"announcer_announcer_rax_fall_enm_bot"	"Spodní kasárny nepřítele byly zničeny."
"[english]announcer_announcer_rax_fall_enm_bot"	"The enemy's bottom barracks has fallen."
"announcer_announcer_twr_deny_yr_top"	"Na tvoji vrchní věž byl použit deny."
"[english]announcer_announcer_twr_deny_yr_top"	"Your top tower has been denied."
"announcer_announcer_twr_deny_yr_mid"	"Na tvoji prostřední věž byl použit deny."
"[english]announcer_announcer_twr_deny_yr_mid"	"Your middle tower has been denied."
"announcer_announcer_twr_deny_yr_bot"	"Na tvoji spodní věž byl použit deny."
"[english]announcer_announcer_twr_deny_yr_bot"	"Your bottom tower has been denied."
"announcer_announcer_twr_deny_enm_top"	"Na vrchní věž nepřítele byl použit deny."
"[english]announcer_announcer_twr_deny_enm_top"	"The enemy's top tower has been denied."
"announcer_announcer_twr_deny_enm_mid"	"Na prostřední věž nepřítele byl použit deny."
"[english]announcer_announcer_twr_deny_enm_mid"	"The enemy's middle tower has been denied."
"announcer_announcer_twr_deny_enm_bot"	"Na spodní věž nepřítele byl použit deny."
"[english]announcer_announcer_twr_deny_enm_bot"	"The enemy's bottom tower has been denied."
"announcer_announcer_twr_deny_rad_top"	"Na vrchní věž týmu Radiant byl použit deny."
"[english]announcer_announcer_twr_deny_rad_top"	"Radiant's top tower has been denied."
"announcer_announcer_twr_deny_rad_mid"	"Na prostřední věž týmu Radiant byl použit deny."
"[english]announcer_announcer_twr_deny_rad_mid"	"Radiant's middle tower has been denied."
"announcer_announcer_twr_deny_rad_bot"	"Na spodní věž týmu Radiant byl použit deny."
"[english]announcer_announcer_twr_deny_rad_bot"	"Radiant's bottom tower has been denied."
"announcer_announcer_twr_deny_dire_top"	"Na vrchní věž týmu Dire byl použit deny."
"[english]announcer_announcer_twr_deny_dire_top"	"Dire's top tower has been denied."
"announcer_announcer_twr_deny_dire_mid"	"Na prostřední věž týmu Dire byl použit deny."
"[english]announcer_announcer_twr_deny_dire_mid"	"Dire's middle tower has been denied."
"announcer_announcer_twr_deny_dire_bot"	"Na spodní věž týmu Dire byl použit deny."
"[english]announcer_announcer_twr_deny_dire_bot"	"Dire's bottom tower has been denied."
"announcer_announcer_fort_dire"	"Budovy týmu Dire jsou opevněny."
"[english]announcer_announcer_fort_dire"	"Dire's structures are fortified."
"announcer_announcer_fort_rad"	"Budovy týmu Radiant jsou opevněny."
"[english]announcer_announcer_fort_rad"	"Radiant's structures are fortified."
"announcer_announcer_cour_kill_dire"	"Kurýr týmu Dire byl zabit."
"[english]announcer_announcer_cour_kill_dire"	"Dire's courier has been killed."
"announcer_announcer_cour_kill_rad"	"Kurýr týmu Radiant byl zabit."
"[english]announcer_announcer_cour_kill_rad"	"Radiant's courier has been killed."
"announcer_announcer_mega_now_you"	"Tvůj tým má nyní mega creepy."
"[english]announcer_announcer_mega_now_you"	"You now have megacreeps."
"announcer_announcer_mega_now_enm"	"Tým nepřítele má nyní mega creepy."
"[english]announcer_announcer_mega_now_enm"	"The enemy now has megacreeps."
"announcer_announcer_mega_now_dire"	"Tým Dire má nyní mega creepy."
"[english]announcer_announcer_mega_now_dire"	"The Dire now have megacreeps."
"announcer_announcer_mega_now_rad"	"Tým Radiant má nyní mega creepy."
"[english]announcer_announcer_mega_now_rad"	"The Radiant now have megacreeps."
"announcer_announcer_roshan_fallen_dire"	"Tým Dire zabil Roshana!"
"[english]announcer_announcer_roshan_fallen_dire"	"Roshan has fallen to the Dire!"
"announcer_announcer_roshan_fallen_rad"	"Tým Radiant zabil Roshana!"
"[english]announcer_announcer_roshan_fallen_rad"	"Roshan has fallen to the Radiant!"
"announcer_announcer_victory_dire"	"Tým Dire zvítězil!"
"[english]announcer_announcer_victory_dire"	"Dire victory!"
"announcer_announcer_victory_rad"	"Tým Radiant zvítězil!"
"[english]announcer_announcer_victory_rad"	"Radiant victory!"
"announcer_announcer_type_all_pick"	"Výběr ze všech."
"[english]announcer_announcer_type_all_pick"	"All Pick."
"announcer_announcer_type_all_random"	"Vše náhodně."
"[english]announcer_announcer_type_all_random"	"All Random."
"announcer_announcer_type_capt_draft"	"Kapitánský výběr."
"[english]announcer_announcer_type_capt_draft"	"Captain's Draft."
"announcer_announcer_type_capt_mode"	"Kapitánský režim."
"[english]announcer_announcer_type_capt_mode"	"Captains Mode."
"announcer_announcer_type_random_draft"	"Náhodný výběr."
"[english]announcer_announcer_type_random_draft"	"Random Draft."
"announcer_announcer_type_single_draft"	"Jediný výběr."
"[english]announcer_announcer_type_single_draft"	"Single Draft."
"announcer_announcer_type_death_match"	"Režim smrti."
"[english]announcer_announcer_type_death_match"	"Death Match."
"announcer_announcer_type_easy_mode"	"Pro nové hráče."
"[english]announcer_announcer_type_easy_mode"	"Easy Mode."
"announcer_announcer_type_rev_capt_mode"	"Obrácený kapitánský režim."
"[english]announcer_announcer_type_rev_capt_mode"	"Reverse Captain's Mode."
"announcer_announcer_type_mid_only"	"Pouze střed."
"[english]announcer_announcer_type_mid_only"	"Mid Only."
"announcer_announcer_type_least_played"	"Nejméně hraní."
"[english]announcer_announcer_type_least_played"	"Least Played."
"announcer_announcer_time_extra"	"Čas navíc."
"[english]announcer_announcer_time_extra"	"Extra time."
"announcer_announcer_time_reserve_using"	"Ubíhá ti rezervní čas."
"[english]announcer_announcer_time_reserve_using"	"You are using Reserve Time."
"announcer_announcer_time_extra_using"	"Ubíhá ti čas navíc."
"[english]announcer_announcer_time_extra_using"	"You are using Extra Time."
"announcer_announcer_alert_disconnection"	"Odpojování."
"[english]announcer_announcer_alert_disconnection"	"Disconnection."
"announcer_announcer_alert_reconnection"	"Opětovné připojování."
"[english]announcer_announcer_alert_reconnection"	"Reconnection."
"announcer_announcer_missing_lane_01"	"Chybí vrchní."
"[english]announcer_announcer_missing_lane_01"	"Top is missing."
"announcer_announcer_missing_lane_02"	"Chybí prostřední."
"[english]announcer_announcer_missing_lane_02"	"Middle is missing."
"announcer_announcer_missing_lane_03"	"Chybí spodní."
"[english]announcer_announcer_missing_lane_03"	"Bottom is missing."
"announcer_announcer_intl2012_game_01"	"1. hra"
"[english]announcer_announcer_intl2012_game_01"	"Game 1."
"announcer_announcer_intl2012_game_02"	"2. hra"
"[english]announcer_announcer_intl2012_game_02"	"Game 2."
"announcer_announcer_intl2012_game_03"	"3. hra"
"[english]announcer_announcer_intl2012_game_03"	"Game 3."
"announcer_announcer_intl2012_game_04"	"4. hra"
"[english]announcer_announcer_intl2012_game_04"	"Game 4"
"announcer_announcer_intl2012_game_05"	"5. hra"
"[english]announcer_announcer_intl2012_game_05"	"Game 5."
"announcer_announcer_intl2012_game_06"	"Závěrečná hra."
"[english]announcer_announcer_intl2012_game_06"	"Final game."
"announcer_announcer_intl2012_itemgranted_01"	"Byl ti udělen předmět."
"[english]announcer_announcer_intl2012_itemgranted_01"	"You have been granted an item."
"announcer_announcer_intl2012_itemgranted_02"	"Byl udělen předmět."
"[english]announcer_announcer_intl2012_itemgranted_02"	"An item has been granted."
"announcer_announcer_intl2012_teamnameban_02"	"Nyní volí ban tým Na'Vi."
"[english]announcer_announcer_intl2012_teamnameban_02"	"Na'Vi's turn to ban."
"announcer_announcer_intl2012_teamnameban_03"	"Nyní volí ban tým DK."
"[english]announcer_announcer_intl2012_teamnameban_03"	"DK's turn to ban."
"announcer_announcer_intl2012_teamnameban_04"	"Nyní volí ban tým Orange."
"[english]announcer_announcer_intl2012_teamnameban_04"	"Orange's turn to ban."
"announcer_announcer_intl2012_teamnameban_06"	"Nyní volí ban tým iG."
"[english]announcer_announcer_intl2012_teamnameban_06"	"iG's turn to ban."
"announcer_announcer_intl2012_teamnameban_10"	"Nyní volí ban tým Zenith."
"[english]announcer_announcer_intl2012_teamnameban_10"	"Zenith's turn to ban."
"announcer_announcer_intl2012_teamnameban_12"	"Nyní volí ban tým LGD."
"[english]announcer_announcer_intl2012_teamnameban_12"	"LGD's turn to ban."
"announcer_announcer_intl2012_teamnameban_15"	"Nyní volí ban tým TongFu."
"[english]announcer_announcer_intl2012_teamnameban_15"	"TongFu's turn to ban."
"announcer_announcer_intl2012_teamnameban_17"	"Nyní volí ban tým Mousesports."
"[english]announcer_announcer_intl2012_teamnameban_17"	"Mousesports' turn to ban."
"announcer_announcer_intl2013_teamnameban_01"	"Nyní volí ban tým Alliance."
"[english]announcer_announcer_intl2013_teamnameban_01"	"Alliance's turn to ban."
"announcer_announcer_intl2013_teamnameban_02"	"Nyní volí ban tým Fnatic."
"[english]announcer_announcer_intl2013_teamnameban_02"	"Fnatic's turn to ban."
"announcer_announcer_intl2013_teamnameban_03"	"Nyní volí ban tým Team Liquid."
"[english]announcer_announcer_intl2013_teamnameban_03"	"Team Liquid's turn to ban."
"announcer_announcer_intl2013_teamnameban_04"	"Nyní volí ban tým Team Dignitas."
"[english]announcer_announcer_intl2013_teamnameban_04"	"Team Dignitas' turn to ban."
"announcer_announcer_intl2013_teamnameban_05"	"Nyní volí ban tým Virtus.Pro."
"[english]announcer_announcer_intl2013_teamnameban_05"	"Virtus.Pro's turn to ban."
"announcer_announcer_intl2013_teamnameban_06"	"Nyní volí ban tým Invasion MUFC."
"[english]announcer_announcer_intl2013_teamnameban_06"	"Invasion MUFC's turn to ban."
"announcer_announcer_intl2013_teamnameban_08"	"Nyní volí ban tým LGD International."
"[english]announcer_announcer_intl2013_teamnameban_08"	"LGD International's turn to ban."
"announcer_announcer_intl2013_teamnameban_11"	"Nyní volí ban tým Quantic Gaming."
"[english]announcer_announcer_intl2013_teamnameban_11"	"Quantic Gaming's turn to ban."
"announcer_announcer_intl2013_teamnameban_12"	"Nyní volí ban tým RattleSnake."
"[english]announcer_announcer_intl2013_teamnameban_12"	"RattleSnake's turn to ban."
"announcer_announcer_intl2012_teamnameban_01"	"Nyní volí ban tým Absolute Legends."
"[english]announcer_announcer_intl2012_teamnameban_01"	"Absolute Legends' turn to ban."
"announcer_announcer_intl2012_teamnameban_05"	"Nyní volí ban tým EHOME."
"[english]announcer_announcer_intl2012_teamnameban_05"	"EHOME's turn to ban."
"announcer_announcer_intl2012_teamnameban_07"	"Nyní volí ban tým ompLexity."
"[english]announcer_announcer_intl2012_teamnameban_07"	"compLexity's turn to ban."
"announcer_announcer_intl2012_teamnameban_08"	"Nyní volí ban tým CLG."
"[english]announcer_announcer_intl2012_teamnameban_08"	"CLG's turn to ban."
"announcer_announcer_intl2012_teamnameban_09"	"Nyní volí ban tým EG."
"[english]announcer_announcer_intl2012_teamnameban_09"	"EG's turn to ban."
"announcer_announcer_intl2012_teamnameban_11"	"Nyní volí ban tým Darer."
"[english]announcer_announcer_intl2012_teamnameban_11"	"Darer's turn to ban."
"announcer_announcer_intl2012_teamnameban_13"	"Nyní volí ban tým MUFC."
"[english]announcer_announcer_intl2012_teamnameban_13"	"MUFC's turn to ban."
"announcer_announcer_intl2012_teamnameban_14"	"Nyní volí ban tým mTw."
"[english]announcer_announcer_intl2012_teamnameban_14"	"mTw's turn to ban."
"announcer_announcer_intl2012_teamnameban_16"	"Nyní volí ban tým World Elite."
"[english]announcer_announcer_intl2012_teamnameban_16"	"World Elite's turn to ban."
"announcer_announcer_intl2012_teamnameban_18"	"Nyní volí ban tým Moscow Five."
"[english]announcer_announcer_intl2012_teamnameban_18"	"Moscow Five's turn to ban."
"announcer_announcer_intl2013_teamnameban_07"	"Nyní volí ban tým LGD."
"[english]announcer_announcer_intl2013_teamnameban_07"	"LGD's turn to ban."
"announcer_announcer_intl2013_teamnameban_09"	"Nyní volí ban tým LGD Cn."
"[english]announcer_announcer_intl2013_teamnameban_09"	"LGD Cn's turn to ban."
"announcer_announcer_intl2013_teamnameban_10"	"Nyní volí ban tým LGD Imposters."
"[english]announcer_announcer_intl2013_teamnameban_10"	"LGD Imposter's turn to ban."
"announcer_announcer_intl2012_teamnamepick_02"	"Nyní vybírá tým Na'Vi."
"[english]announcer_announcer_intl2012_teamnamepick_02"	"Na'Vi's turn to pick."
"announcer_announcer_intl2012_teamnamepick_03"	"Nyní vybírá tým DK."
"[english]announcer_announcer_intl2012_teamnamepick_03"	"DK's turn to pick."
"announcer_announcer_intl2012_teamnamepick_04"	"Nyní vybírá tým Orange."
"[english]announcer_announcer_intl2012_teamnamepick_04"	"Orange's turn to pick."
"announcer_announcer_intl2012_teamnamepick_06"	"Nyní vybírá tým iG."
"[english]announcer_announcer_intl2012_teamnamepick_06"	"iG's turn to pick."
"announcer_announcer_intl2012_teamnamepick_10"	"Nyní vybírá tým Zenith."
"[english]announcer_announcer_intl2012_teamnamepick_10"	"Zenith's turn to pick."
"announcer_announcer_intl2012_teamnamepick_12"	"Nyní vybírá tým LGD."
"[english]announcer_announcer_intl2012_teamnamepick_12"	"LGD's turn to pick."
"announcer_announcer_intl2012_teamnamepick_15"	"Nyní vybírá tým TongFu."
"[english]announcer_announcer_intl2012_teamnamepick_15"	"TongFu's turn to pick."
"announcer_announcer_intl2012_teamnamepick_17"	"Nyní vybírá tým Mousesports."
"[english]announcer_announcer_intl2012_teamnamepick_17"	"Mousesports' turn to pick."
"announcer_announcer_intl2013_teamnamepick_01"	"Nyní vybírá tým Alliance."
"[english]announcer_announcer_intl2013_teamnamepick_01"	"Alliance's turn to pick."
"announcer_announcer_intl2013_teamnamepick_02"	"Nyní vybírá tým Fnatic."
"[english]announcer_announcer_intl2013_teamnamepick_02"	"Fnatic's turn to pick."
"announcer_announcer_intl2013_teamnamepick_03"	"Nyní vybírá tým Team Liquid."
"[english]announcer_announcer_intl2013_teamnamepick_03"	"Team Liquid's turn to pick."
"announcer_announcer_intl2013_teamnamepick_04"	"Nyní vybírá tým Team Dignitas."
"[english]announcer_announcer_intl2013_teamnamepick_04"	"Team Dignitas' turn to pick."
"announcer_announcer_intl2013_teamnamepick_05"	"Nyní vybírá tým Virtus.Pro."
"[english]announcer_announcer_intl2013_teamnamepick_05"	"Virtus.Pro's turn to pick."
"announcer_announcer_intl2013_teamnamepick_06"	"Nyní vybírá tým Invasion MUFC."
"[english]announcer_announcer_intl2013_teamnamepick_06"	"Invasion MUFC's turn to pick."
"announcer_announcer_intl2013_teamnamepick_08"	"Nyní vybírá tým LGD International."
"[english]announcer_announcer_intl2013_teamnamepick_08"	"LGD International's turn to pick."
"announcer_announcer_intl2013_teamnamepick_11"	"Nyní vybírá tým Quantic Gaming."
"[english]announcer_announcer_intl2013_teamnamepick_11"	"Quantic Gaming's turn to pick."
"announcer_announcer_intl2013_teamnamepick_12"	"Nyní vybírá tým RattleSnake."
"[english]announcer_announcer_intl2013_teamnamepick_12"	"RattleSnake's turn to pick."
"announcer_announcer_intl2012_teamnamepick_01"	"Nyní vybírá tým Absolute Legends."
"[english]announcer_announcer_intl2012_teamnamepick_01"	"Absolute Legends' turn to pick."
"announcer_announcer_intl2012_teamnamepick_05"	"Nyní vybírá tým EHOME."
"[english]announcer_announcer_intl2012_teamnamepick_05"	"EHOME's turn to pick."
"announcer_announcer_intl2012_teamnamepick_07"	"Nyní vybírá tým compLexity."
"[english]announcer_announcer_intl2012_teamnamepick_07"	"compLexity's turn to pick."
"announcer_announcer_intl2012_teamnamepick_08"	"Nyní vybírá tým CLG."
"[english]announcer_announcer_intl2012_teamnamepick_08"	"CLG's turn to pick."
"announcer_announcer_intl2012_teamnamepick_09"	"Nyní vybírá tým EG."
"[english]announcer_announcer_intl2012_teamnamepick_09"	"EG's turn to pick."
"announcer_announcer_intl2012_teamnamepick_11"	"Nyní vybírá tým Darer."
"[english]announcer_announcer_intl2012_teamnamepick_11"	"Darer's turn to pick."
"announcer_announcer_intl2012_teamnamepick_13"	"Nyní vybírá tým MUFC."
"[english]announcer_announcer_intl2012_teamnamepick_13"	"MUFC's turn to pick."
"announcer_announcer_intl2012_teamnamepick_14"	"Nyní vybírá tým mTw."
"[english]announcer_announcer_intl2012_teamnamepick_14"	"mTw's turn to pick."
"announcer_announcer_intl2012_teamnamepick_16"	"Nyní vybírá tým World Elite."
"[english]announcer_announcer_intl2012_teamnamepick_16"	"World Elite's turn to pick."
"announcer_announcer_intl2012_teamnamepick_18"	"Nyní vybírá tým Moscow Five."
"[english]announcer_announcer_intl2012_teamnamepick_18"	"Moscow Five's turn to pick."
"announcer_announcer_intl2013_teamnamepick_07"	"Nyní vybírá tým LGD."
"[english]announcer_announcer_intl2013_teamnamepick_07"	"LGD's turn to pick."
"announcer_announcer_intl2013_teamnamepick_09"	"Nyní vybírá tým LGD Cn."
"[english]announcer_announcer_intl2013_teamnamepick_09"	"LGD Cn's turn to pick."
"announcer_announcer_intl2013_teamnamepick_10"	"Nyní vybírá tým LGD Imposters."
"[english]announcer_announcer_intl2013_teamnamepick_10"	"LGD Imposter's turn to pick."
"announcer_announcer_intl2012_teamnames_01"	"aL"
"[english]announcer_announcer_intl2012_teamnames_01"	"aL"
"announcer_announcer_intl2012_teamnames_02"	"Absolute Legends"
"[english]announcer_announcer_intl2012_teamnames_02"	"Absolute Legends"
"announcer_announcer_intl2012_teamnames_03"	"Na'Vi"
"[english]announcer_announcer_intl2012_teamnames_03"	"Na'Vi"
"announcer_announcer_intl2012_teamnames_04"	"Natus Vincere"
"[english]announcer_announcer_intl2012_teamnames_04"	"Natus Vincere"
"announcer_announcer_intl2012_teamnames_05"	"DK"
"[english]announcer_announcer_intl2012_teamnames_05"	"DK"
"announcer_announcer_intl2012_teamnames_06"	"Orange"
"[english]announcer_announcer_intl2012_teamnames_06"	"Orange"
"announcer_announcer_intl2012_teamnames_07"	"EHOME"
"[english]announcer_announcer_intl2012_teamnames_07"	"EHOME"
"announcer_announcer_intl2012_teamnames_08"	"iG"
"[english]announcer_announcer_intl2012_teamnames_08"	"iG"
"announcer_announcer_intl2012_teamnames_09"	"Invictus Gaming"
"[english]announcer_announcer_intl2012_teamnames_09"	"Invictus Gaming"
"announcer_announcer_intl2012_teamnames_10"	"coL"
"[english]announcer_announcer_intl2012_teamnames_10"	"coL"
"announcer_announcer_intl2012_teamnames_11"	"compLexity"
"[english]announcer_announcer_intl2012_teamnames_11"	"compLexity"
"announcer_announcer_intl2012_teamnames_12"	"CLG"
"[english]announcer_announcer_intl2012_teamnames_12"	"CLG"
"announcer_announcer_intl2012_teamnames_13"	"Counter Logic Gaming"
"[english]announcer_announcer_intl2012_teamnames_13"	"Counter Logic Gaming"
"announcer_announcer_intl2012_teamnames_14"	"EG"
"[english]announcer_announcer_intl2012_teamnames_14"	"EG"
"announcer_announcer_intl2012_teamnames_15"	"Evil Geniuses"
"[english]announcer_announcer_intl2012_teamnames_15"	"Evil Geniuses"
"announcer_announcer_intl2012_teamnames_16"	"Zenith"
"[english]announcer_announcer_intl2012_teamnames_16"	"Zenith"
"announcer_announcer_intl2012_teamnames_17"	"Darer"
"[english]announcer_announcer_intl2012_teamnames_17"	"Darer"
"announcer_announcer_intl2012_teamnames_18"	"LGD"
"[english]announcer_announcer_intl2012_teamnames_18"	"LGD"
"announcer_announcer_intl2012_teamnames_19"	"MUFC"
"[english]announcer_announcer_intl2012_teamnames_19"	"MUFC"
"announcer_announcer_intl2012_teamnames_20"	"M5"
"[english]announcer_announcer_intl2012_teamnames_20"	"M5"
"announcer_announcer_intl2012_teamnames_21"	"Moscow Five"
"[english]announcer_announcer_intl2012_teamnames_21"	"Moscow Five"
"announcer_announcer_intl2012_teamnames_22"	"mTw"
"[english]announcer_announcer_intl2012_teamnames_22"	"mTw"
"announcer_announcer_intl2012_teamnames_23"	"Mortal Teamwork"
"[english]announcer_announcer_intl2012_teamnames_23"	"Mortal Teamwork"
"announcer_announcer_intl2012_teamnames_24"	"TongFu"
"[english]announcer_announcer_intl2012_teamnames_24"	"TongFu"
"announcer_announcer_intl2012_teamnames_25"	"WE"
"[english]announcer_announcer_intl2012_teamnames_25"	"WE"
"announcer_announcer_intl2012_teamnames_26"	"World Elite"
"[english]announcer_announcer_intl2012_teamnames_26"	"World Elite"
"announcer_announcer_intl2012_teamnames_27"	"Mouz"
"[english]announcer_announcer_intl2012_teamnames_27"	"Mouz"
"announcer_announcer_intl2012_teamnames_28"	"Mousesports"
"[english]announcer_announcer_intl2012_teamnames_28"	"Mousesports"
"announcer_announcer_intl2013_teamnames_01"	"Alliance"
"[english]announcer_announcer_intl2013_teamnames_01"	"Alliance"
"announcer_announcer_intl2013_teamnames_02"	"Fnatic"
"[english]announcer_announcer_intl2013_teamnames_02"	"Fnatic"
"announcer_announcer_intl2013_teamnames_03"	"Team Liquid"
"[english]announcer_announcer_intl2013_teamnames_03"	"Team Liquid"
"announcer_announcer_intl2013_teamnames_04"	"Team Dignitas"
"[english]announcer_announcer_intl2013_teamnames_04"	"Team Dignitas"
"announcer_announcer_intl2013_teamnames_05"	"Virtus.Pro"
"[english]announcer_announcer_intl2013_teamnames_05"	"Virtus.Pro"
"announcer_announcer_intl2013_teamnames_06"	"Invasion MUFC"
"[english]announcer_announcer_intl2013_teamnames_06"	"Invasion MUFC"
"announcer_announcer_intl2013_teamnames_07"	"LGD"
"[english]announcer_announcer_intl2013_teamnames_07"	"LGD"
"announcer_announcer_intl2013_teamnames_08"	"LGD International"
"[english]announcer_announcer_intl2013_teamnames_08"	"LGD International"
"announcer_announcer_intl2013_teamnames_09"	"LGD cn"
"[english]announcer_announcer_intl2013_teamnames_09"	"LGD cn"
"announcer_announcer_intl2013_teamnames_10"	"LGD Imposters"
"[english]announcer_announcer_intl2013_teamnames_10"	"LGD Imposters"
"announcer_announcer_intl2013_teamnames_11"	"Quantic Gaming"
"[english]announcer_announcer_intl2013_teamnames_11"	"Quantic Gaming"
"announcer_announcer_intl2013_teamnames_12"	"RattleSnake"
"[english]announcer_announcer_intl2013_teamnames_12"	"RattleSnake"
"announcer_announcer_intl2012_teamnamevictory_01"	"Tým Absolute Legends zvítězil!"
"[english]announcer_announcer_intl2012_teamnamevictory_01"	"Absolute Legends victory!"
"announcer_announcer_intl2012_teamnamevictory_02"	"Tým Na'Vi zvítězil!"
"[english]announcer_announcer_intl2012_teamnamevictory_02"	"Na'Vi victory!"
"announcer_announcer_intl2012_teamnamevictory_03"	"Tým DK zvítězil!"
"[english]announcer_announcer_intl2012_teamnamevictory_03"	"DK victory!"
"announcer_announcer_intl2012_teamnamevictory_04"	"Tým Orange zvítězil!"
"[english]announcer_announcer_intl2012_teamnamevictory_04"	"Orange victory!"
"announcer_announcer_intl2012_teamnamevictory_05"	"Tým EHOME zvítězil!"
"[english]announcer_announcer_intl2012_teamnamevictory_05"	"EHOME victory!"
"announcer_announcer_intl2012_teamnamevictory_06"	"Tým iG zvítězil!"
"[english]announcer_announcer_intl2012_teamnamevictory_06"	"iG victory!"
"announcer_announcer_intl2012_teamnamevictory_07"	"Tým compLexity zvítězil!"
"[english]announcer_announcer_intl2012_teamnamevictory_07"	"compLexity victory!"
"announcer_announcer_intl2012_teamnamevictory_08"	"Tým CLG zvítězil!"
"[english]announcer_announcer_intl2012_teamnamevictory_08"	"CLG victory!"
"announcer_announcer_intl2012_teamnamevictory_09"	"Tým EG zvítězil!"
"[english]announcer_announcer_intl2012_teamnamevictory_09"	"EG victory!"
"announcer_announcer_intl2012_teamnamevictory_10"	"Tým Zenith zvítězil!"
"[english]announcer_announcer_intl2012_teamnamevictory_10"	"Zenith victory!"
"announcer_announcer_intl2012_teamnamevictory_11"	"Tým Darer zvítězil!"
"[english]announcer_announcer_intl2012_teamnamevictory_11"	"Darer victory!"
"announcer_announcer_intl2012_teamnamevictory_12"	"Tým LGD zvítězil!"
"[english]announcer_announcer_intl2012_teamnamevictory_12"	"LGD victory!"
"announcer_announcer_intl2012_teamnamevictory_13"	"Tým MUFC zvítězil!"
"[english]announcer_announcer_intl2012_teamnamevictory_13"	"MUFC victory!"
"announcer_announcer_intl2012_teamnamevictory_14"	"Tým Moscow Five zvítězil!"
"[english]announcer_announcer_intl2012_teamnamevictory_14"	"Moscow Five victory!"
"announcer_announcer_intl2012_teamnamevictory_15"	"Tým mTw zvítězil!"
"[english]announcer_announcer_intl2012_teamnamevictory_15"	"mTw victory!"
"announcer_announcer_intl2012_teamnamevictory_16"	"Tým TongFu zvítězil!"
"[english]announcer_announcer_intl2012_teamnamevictory_16"	"TongFu victory!"
"announcer_announcer_intl2012_teamnamevictory_17"	"Tým World Elite zvítězil!"
"[english]announcer_announcer_intl2012_teamnamevictory_17"	"World Elite victory!"
"announcer_announcer_intl2012_teamnamevictory_18"	"Tým Mousesports zvítězil!"
"[english]announcer_announcer_intl2012_teamnamevictory_18"	"Mousesports victory!"
"announcer_announcer_intl2013_teamnamevictory_01"	"Tým Alliance zvítězil!"
"[english]announcer_announcer_intl2013_teamnamevictory_01"	"Alliance victory!"
"announcer_announcer_intl2013_teamnamevictory_02"	"Tým Fnatic zvítězil!"
"[english]announcer_announcer_intl2013_teamnamevictory_02"	"Fnatic victory!"
"announcer_announcer_intl2013_teamnamevictory_03"	"Tým Team Liquid zvítězil!"
"[english]announcer_announcer_intl2013_teamnamevictory_03"	"Team Liquid victory!"
"announcer_announcer_intl2013_teamnamevictory_04"	"Tým Team Dignitas zvítězil!"
"[english]announcer_announcer_intl2013_teamnamevictory_04"	"Team Dignitas victory!"
"announcer_announcer_intl2013_teamnamevictory_05"	"Tým Virtus.Pro zvítězil!"
"[english]announcer_announcer_intl2013_teamnamevictory_05"	"Virtus.Pro victory!"
"announcer_announcer_intl2013_teamnamevictory_06"	"Tým LGD zvítězil!"
"[english]announcer_announcer_intl2013_teamnamevictory_06"	"LGD victory!"
"announcer_announcer_intl2013_teamnamevictory_07"	"Tým LGD International zvítězil!"
"[english]announcer_announcer_intl2013_teamnamevictory_07"	"LGD International victory!"
"announcer_announcer_intl2013_teamnamevictory_08"	"Tým LGD.cl zvítězil!"
"[english]announcer_announcer_intl2013_teamnamevictory_08"	"LGD.cn victory!"
"announcer_announcer_intl2013_teamnamevictory_09"	"Tým LGD Imposters zvítězil!"
"[english]announcer_announcer_intl2013_teamnamevictory_09"	"LGD Imposters victory!"
"announcer_announcer_intl2013_teamnamevictory_10"	"Tým Invasion MUFC zvítězil!"
"[english]announcer_announcer_intl2013_teamnamevictory_10"	"Invasion MUFC victory!"
"announcer_announcer_intl2013_teamnamevictory_11"	"Tým Quantic Gaming zvítězil!"
"[english]announcer_announcer_intl2013_teamnamevictory_11"	"Quantic Gaming victory!"
"announcer_announcer_intl2013_teamnamevictory_12"	"Tým RattleSnake zvítězil!"
"[english]announcer_announcer_intl2013_teamnamevictory_12"	"RattleSnake victory!"
"announcer_announcer_intl2012_tourneystage_01"	"Čtvrtfinále."
"[english]announcer_announcer_intl2012_tourneystage_01"	"Quarter-Finals."
"announcer_announcer_intl2012_tourneystage_02"	"Semifinále."
"[english]announcer_announcer_intl2012_tourneystage_02"	"Semi-Finals."
"announcer_announcer_intl2012_tourneystage_03"	"Velké finále."
"[english]announcer_announcer_intl2012_tourneystage_03"	"Grand Finals."
"announcer_announcer_intl2012_usher_01"	"Přestávka."
"[english]announcer_announcer_intl2012_usher_01"	"Intermission."
"announcer_announcer_intl2012_usher_02"	"Prosím o pozornost."
"[english]announcer_announcer_intl2012_usher_02"	"Your attention please."
"announcer_announcer_intl2012_usher_03"	"Za pár okamžiků začne další hra."
"[english]announcer_announcer_intl2012_usher_03"	"The next game is about to begin."
"announcer_announcer_intl2012_versus_01"	"proti"
"[english]announcer_announcer_intl2012_versus_01"	"versus"
"announcer_announcer_intl2012_welcome_01"	"Vítejte na šampionátu The International!"
"[english]announcer_announcer_intl2012_welcome_01"	"Welcome to the Dota 2 International!"
}
}
