"lang"
{
"Language"	"schinese"
"Tokens"
{
"announcer_killing_spree_announcer_kill_double_01"	"双杀！"
"[english]announcer_killing_spree_announcer_kill_double_01"	"Double kill!"
"announcer_killing_spree_announcer_kill_triple_01"	"三杀！"
"[english]announcer_killing_spree_announcer_kill_triple_01"	"Triple kill!"
"announcer_killing_spree_announcer_kill_ultra_01"	"疯狂杀戮！"
"[english]announcer_killing_spree_announcer_kill_ultra_01"	"Ultra kill!"
"announcer_killing_spree_announcer_kill_rampage_01"	"暴走！"
"[english]announcer_killing_spree_announcer_kill_rampage_01"	"Rampage!"
"announcer_killing_spree_announcer_kill_spree_01"	"大杀特杀！"
"[english]announcer_killing_spree_announcer_kill_spree_01"	"Killing spree!"
"announcer_killing_spree_announcer_kill_dominate_01"	"主宰比赛！"
"[english]announcer_killing_spree_announcer_kill_dominate_01"	"Dominating!"
"announcer_killing_spree_announcer_kill_mega_01"	"杀人如麻！"
"[english]announcer_killing_spree_announcer_kill_mega_01"	"Mega kill!"
"announcer_killing_spree_announcer_kill_unstop_01"	"无人能挡！"
"[english]announcer_killing_spree_announcer_kill_unstop_01"	"Unstoppable!"
"announcer_killing_spree_announcer_kill_wicked_01"	"变态杀戮！"
"[english]announcer_killing_spree_announcer_kill_wicked_01"	"Wicked sick!"
"announcer_killing_spree_announcer_kill_monster_01"	"妖怪般的杀戮！"
"[english]announcer_killing_spree_announcer_kill_monster_01"	"Monster kill!"
"announcer_killing_spree_announcer_kill_godlike_01"	"如同神一般！"
"[english]announcer_killing_spree_announcer_kill_godlike_01"	"Godlike!"
"announcer_killing_spree_announcer_kill_holy_01"	"超越神的杀戮！"
"[english]announcer_killing_spree_announcer_kill_holy_01"	"Holy shit!"
"announcer_killing_spree_announcer_1stblood_01"	"第一滴血！"
"[english]announcer_killing_spree_announcer_1stblood_01"	"First blood!"
"announcer_killing_spree_announcer_ownage_01"	"正在向胜利迈进！"
"[english]announcer_killing_spree_announcer_ownage_01"	"Ownage!"
}
}
